freeCodeCamp,freeCodeCamp,310708,14411,14215,196
996icu,996.ICU,249539,0,0,0
vuejs,vue,163964,8990,8675,315
facebook,react,148635,9141,8646,495
EbookFoundation,free-programming-books,147459,427,400,27
tensorflow,tensorflow,144317,25002,21585,3417
twbs,bootstrap,140747,19257,18972,285
sindresorhus,awesome,133036,251,235,16
getify,You-Dont-Know-JS,121182,834,761,73
jwasham,coding-interview-university,114936,115,86,29
ohmyzsh,ohmyzsh,109704,3333,3106,227
kamranahmedse,developer-roadmap,108087,420,405,15
github,gitignore,101534,0,0,0
CyC2018,CS-Notes,100908,399,368,31
microsoft,vscode,96282,89232,84437,4795
airbnb,javascript,95373,985,906,79
donnemartin,system-design-primer,95190,117,33,84
flutter,flutter,92402,37004,29431,7573
d3,d3,91478,2036,2032,4
torvalds,linux,90946,0,0,0
facebook,react-native,87182,19351,18607,744
jackfrued,Python-100-Days,85606,353,65,288
electron,electron,82661,12920,11783,1137
vinta,awesome-python,82407,167,165,2
public-apis,public-apis,81870,128,123,5
facebook,create-react-app,78664,5804,5298,506
Snailclimb,JavaGuide,78655,383,359,24
jlevy,the-art-of-command-line,75322,163,80,83
axios,axios,73194,2288,2054,234
golang,go,72496,37767,32102,5665
TheAlgorithms,Python,71643,296,286,10
danistefanovic,build-your-own-x,70700,315,264,51
trekhleb,javascript-algorithms,70081,135,83,52
nodejs,node,69969,11601,10617,984
animate-css,animate.css,66644,707,706,1
justjavac,free-programming-books-zh_CN,66427,0,0,0
ytdl-org,youtube-dl,66110,20283,17488,2795
kubernetes,kubernetes,66011,34716,32698,2018
tensorflow,models,63694,5297,4489,808
FortAwesome,Font-Awesome,62819,15964,10670,5294
microsoft,terminal,61480,4615,3748,867
puppeteer,puppeteer,61310,3946,2951,995
angular,angular,60988,20762,17909,2853
mrdoob,three.js,60542,9712,9267,445
microsoft,TypeScript,60363,26315,21853,4462
ossu,computer-science,59773,450,443,7
ant-design,ant-design,59705,17292,16830,462
angular,angular.js,59530,8986,8596,390
laravel,laravel,59132,0,0,0
iluwatar,java-design-patterns,57708,542,379,163
mui-org,material-ui,57327,11082,10693,389
moby,moby,57046,20177,16576,3601
30-seconds,30-seconds-of-code,56532,242,242,0
avelino,awesome-go,54357,218,211,7
PanJiaChen,vue-element-admin,54289,2707,2111,596
webpack,webpack,54188,7104,6737,367
vuejs,awesome-vue,54092,170,109,61
MisterBooo,LeetCodeAnimation,53982,32,32,0
denoland,deno,53490,2041,1540,501
nvbn,thefuck,53462,542,352,190
jquery,jquery,53314,2008,1945,63
reduxjs,redux,53196,1760,1729,31
atom,atom,51892,15682,15110,572
apple,swift,51574,0,0,0
hakimel,reveal.js,51554,1781,1312,469
pallets,flask,50314,1930,1909,21
socketio,socket.io,49600,2841,2362,479
shadowsocks,shadowsocks-windows,49300,2495,2447,48
django,django,49278,0,0,0
elastic,elasticsearch,48854,23724,21286,2438
chartjs,Chart.js,48700,5119,4717,402
expressjs,express,48601,3280,3185,95
zeit,next.js,48217,6366,5905,461
keras-team,keras,48198,10108,7138,2970
storybookjs,storybook,48006,5324,4790,534
Semantic-Org,Semantic-UI,47854,6092,5212,880
spring-projects,spring-boot,47684,17134,16710,424
typicode,json-server,47319,865,394,471
chrislgarry,Apollo-11,47066,359,264,95
tonsky,FiraCode,46973,898,656,242
jakubroztocil,httpie,46698,603,464,139
netdata,netdata,46647,5247,4528,719
adam-p,markdown-here,46376,544,291,253
rails,rails,45579,13738,13350,388
xingshaocheng,architect-awesome,45330,62,18,44
ElemeFE,element,45241,15055,13568,1487
h5bp,html5-boilerplate,44824,1168,1165,3
lodash,lodash,44764,3670,3607,63
rust-lang,rust,44734,34192,28756,5436
josephmisiti,awesome-machine-learning,44617,63,63,0
opencv,opencv,44503,6587,4863,1724
awesome-selfhosted,awesome-selfhosted,44418,513,450,63
h5bp,Front-end-Developer-Interview-Questions,44413,97,93,4
resume,resume.github.com,44383,83,54,29
kdn251,interviews,44333,43,16,27
gatsbyjs,gatsby,44330,10397,9749,648
moment,moment,44003,3664,3407,257
gohugoio,hugo,43964,4610,4135,475
goldbergyoni,nodebestpractices,43766,180,162,18
doocs,advanced-java,43471,95,85,10
bitcoin,bitcoin,43373,5422,4930,492
ansible,ansible,43126,27134,23007,4127
antirez,redis,42845,4190,2377,1813
ReactiveX,RxJava,42639,2918,2902,16
yangshun,tech-interview-handbook,42637,0,0,0
psf,requests,42460,3133,2913,220
meteor,meteor,41756,8320,8222,98
nvm-sh,nvm,41743,1384,1142,242
mtdvio,every-programmer-should-know,41562,28,16,12
protocolbuffers,protobuf,41516,3896,2988,908
kelseyhightower,nocode,41437,3531,418,3113
apache,incubator-echarts,40971,11910,10169,1741
ionic-team,ionic,40954,17435,16681,754
scikit-learn,scikit-learn,40639,7438,5903,1535
ReactTraining,react-router,40481,5424,5391,33
gothinkster,realworld,40426,341,141,200
papers-we-love,papers-we-love,40386,128,117,11
jekyll,jekyll,40380,4181,4098,83
google,material-design-icons,40173,863,306,557
labuladong,fucking-algorithm,40143,165,132,33
jgthms,bulma,39736,2016,1808,208
thedaviddias,Front-End-Checklist,39279,108,94,14
awesomedata,awesome-public-datasets,39173,88,42,46
necolas,normalize.css,38859,458,439,19
pytorch,pytorch,38638,14119,9790,4329
yarnpkg,yarn,38460,5804,3683,2121
gin-gonic,gin,38025,1379,1166,213
wasabeef,awesome-android-ui,37854,0,0,0
scutan90,DeepLearning-500-questions,37815,151,75,76
NARKOZ,hacker-scripts,37810,56,24,32
jaywcjlove,awesome-mac,37649,261,209,52
Dogfalo,materialize,37508,5122,4542,580
google,guava,37277,3116,2485,631
aymericdamien,TensorFlow-Examples,37268,208,61,147
scrapy,scrapy,37094,2189,1749,440
Hack-with-Github,Awesome-Hacking,37071,0,0,0
square,okhttp,37027,3071,3009,62
spring-projects,spring-framework,36966,19476,18605,871
enaqx,awesome-react,36873,63,60,3
FreeCodeCampChina,freecodecamp.cn,36827,585,442,143
nwjs,nw.js,36811,6654,5900,754
neovim,neovim,36607,5513,4650,863
babel,babel,36524,7095,6469,626
prettier,prettier,36475,4199,3579,620
android,architecture-samples,36375,381,272,109
minimaxir,big-list-of-naughty-strings,35936,72,27,45
serverless,serverless,35851,4362,3588,774
fatedier,frp,35768,1431,1385,46
sindresorhus,awesome-nodejs,35730,89,89,0
ryanmcdermott,clean-code-javascript,35703,91,61,30
impress,impress.js,35680,436,392,44
parcel-bundler,parcel,35680,2977,2425,552
square,retrofit,35581,2365,2275,90
juliangarnier,anime,35367,534,437,97
nodejs,node-v0.x-archive,35163,6383,5848,535
ripienaar,free-for-dev,35151,0,0,0
x64dbg,x64dbg,35067,1796,1409,387
grafana,grafana,34945,15924,13360,2564
ziishaned,learn-regex,34896,68,32,36
vsouza,awesome-ios,34843,432,432,0
astaxie,build-web-application-with-golang,34639,277,170,107
ColorlibHQ,AdminLTE,34466,2158,2108,50
macrozheng,mall,34395,273,260,13
tesseract-ocr,tesseract,34372,1824,1547,277
gogs,gogs,34275,4541,3880,661
ageitgey,face_recognition,34116,985,508,477
MaximAbramchuck,awesome-interview-questions,34097,22,19,3
sveltejs,svelte,33673,2778,2380,398
TryGhost,Ghost,33650,5751,5696,55
k88hudson,git-flight-rules,33629,54,46,8
Alamofire,Alamofire,33488,2337,2316,21
prakhar1989,awesome-courses,33306,58,33,25
zeit,hyper,33250,2986,2230,756
bailicangdu,vue2-elm,33133,494,424,70
home-assistant,core,33121,14352,13383,969
soimort,you-get,32971,0,0,0
AFNetworking,AFNetworking,32748,3025,3008,17
shadowsocks,shadowsocks,32626,0,0,0
git,git,32528,0,0,0
tuvtran,project-based-learning,32396,26,15,11
Unitech,pm2,32358,3950,3096,854
trimstray,the-book-of-secret-knowledge,32298,37,36,1
apache,dubbo,32256,3416,2894,522
azl397985856,leetcode,32057,161,137,24
leonardomso,33-js-concepts,31799,26,24,2
JetBrains,kotlin,31744,0,0,0
gulpjs,gulp,31734,1801,1772,29
sdmg15,Best-websites-a-programmer-should-visit,31624,46,45,1
google,material-design-lite,31594,2144,1787,357
justjavac,awesome-wechat-weapp,31313,0,0,0
adobe,brackets,31306,9493,6999,2494
v2ray,v2ray-core,31264,2121,1908,213
syncthing,syncthing,31162,4062,3819,243
python,cpython,31054,0,0,0
etcd-io,etcd,31027,4855,4652,203
facebook,jest,30936,5361,4435,926
cdr,code-server,30779,1354,1254,100
karan,Projects,30742,56,29,27
prometheus,prometheus,30736,3340,3061,279
discourse,discourse,30667,0,0,0
PhilJay,MPAndroidChart,30659,4441,2779,1662
blueimp,jQuery-File-Upload,30652,3221,3176,45
mozilla,pdf.js,30624,6756,6164,592
deepfakes,faceswap,30427,598,585,13
hexojs,hexo,30387,3463,3332,131
godotengine,godot,30292,22740,16912,5828
BVLC,caffe,30255,4704,3866,838
Genymobile,scrcpy,30206,1268,883,385
tiimgreen,github-cheat-sheet,30122,43,40,3
sahat,hackathon-starter,30068,565,555,10
XX-net,XX-Net,30029,12451,4983,7468
alvarotrigo,fullPage.js,30009,3493,3336,157
mermaid-js,mermaid,29933,1009,839,170
Trinea,android-open-project,29897,80,68,12
521xueweihan,HelloGitHub,29740,1189,1172,17
slatedocs,slate,29737,547,506,41
immutable-js,immutable-js,29678,1165,1022,143
shadowsocks,shadowsocks-android,29639,2161,2145,16
pixijs,pixi.js,29479,4042,3972,70
styled-components,styled-components,29329,2093,1978,115
junegunn,fzf,29205,1596,1434,162
algorithm-visualizer,algorithm-visualizer,29190,73,61,12
koajs,koa,29142,773,750,23
bumptech,glide,29012,3707,3566,141
containous,traefik,28786,3722,3231,491
airbnb,lottie-android,28755,1129,1091,38
chinese-poetry,chinese-poetry,28741,120,71,49
apache,incubator-superset,28716,4460,4208,252
fastlane,fastlane,28705,10510,10359,151
foundation,foundation-sites,28617,7955,7697,258
Avik-Jain,100-Days-Of-ML-Code,28608,0,0,0
exacity,deeplearningbook-chinese,28552,175,130,45
zenorocha,clipboard.js,28537,523,513,10
caddyserver,caddy,28495,2140,2070,70
testerSunshine,12306,28421,624,455,169
huginn,huginn,28333,1683,1306,377
videojs,video.js,28290,3999,3771,228
kamranahmedse,design-patterns-for-humans,28157,49,42,7
DefinitelyTyped,DefinitelyTyped,27980,6524,3286,3238
Leaflet,Leaflet,27830,4281,3885,396
Homebrew,legacy-homebrew,27801,17038,17038,0
Solido,awesome-flutter,27762,0,0,0
shadowsocks,ShadowsocksX-NG,27732,1190,982,208
jashkenas,backbone,27641,2384,2329,55
lukehoban,es6features,27573,55,36,19
ariya,phantomjs,27565,4709,4679,30
photonstorm,phaser,27252,3260,3064,196
php,php-src,27222,0,0,0
isocpp,CppCoreGuidelines,27196,799,637,162
jondot,awesome-react-native,27147,52,33,19
dypsilon,frontend-dev-bookmarks,27125,93,77,16
iamkun,dayjs,27114,399,337,62
nuxt,nuxt.js,27086,5117,4830,287
joshbuchea,HEAD,27078,82,71,11
JuliaLang,julia,27064,17734,14836,2898
Blankj,AndroidUtilCode,27013,1066,1054,12
tldr-pages,tldr,26945,514,445,69
nestjs,nest,26841,2578,2507,71
0voice,interview_internal_reference,26761,36,18,18
huggingface,transformers,26691,2936,2490,446
certbot,certbot,26684,4376,3865,511
codepath,android_guides,26677,362,211,151
RocketChat,Rocket.Chat,26644,10701,8493,2208
tastejs,todomvc,26563,734,618,116
caolan,async,26526,1049,1045,4
bilibili,ijkplayer,26438,4831,2413,2418
quilljs,quill,26437,2587,1807,780
xitu,gold-miner,26235,4380,4339,41
preactjs,preact,26214,1182,1083,99
open-guides,og-aws,26164,199,79,120
floodsung,Deep-Learning-Papers-Reading-Roadmap,26161,41,3,38
grpc,grpc,26090,8510,8135,375
apache,spark,26048,0,0,0
bayandin,awesome-awesomeness,26039,55,49,6
alex,what-happens-when,26037,100,19,81
ethereum,go-ethereum,25913,4841,4583,258
binhnguyennus,awesome-scalability,25909,0,0,0
Kong,kong,25714,2948,2626,322
proxyee-down-org,proxyee-down,25618,0,0,0
kenwheeler,slick,25518,3309,2320,989
fffaraz,awesome-cpp,25481,450,149,301
react-boilerplate,react-boilerplate,25433,1787,1762,25
vuetifyjs,vuetify,25374,8388,7318,1070
jashkenas,underscore,25325,1357,1324,33
zxing,zxing,25305,996,988,8
JakeWharton,butterknife,25273,1122,1029,93
NervJS,taro,25265,5201,4329,872
vuejs,vue-cli,25263,4235,3763,472
shengxinjing,programmer-job-blacklist,25047,290,169,121
ant-design,ant-design-pro,24978,5397,5309,88
aosabook,500lines,24958,61,36,25
pandas-dev,pandas,24903,17940,14586,3354
getsentry,sentry,24856,4033,3106,927
apachecn,AiLearning,24853,88,55,33
strapi,strapi,24733,3468,3235,233
faif,python-patterns,24705,61,52,9
square,leakcanary,24696,1131,1094,37
akullpp,awesome-java,24636,96,95,1
crossoverJie,JCSprout,24620,87,59,28
danielmiessler,SecLists,24605,106,98,8
request,request,24556,2145,2006,139
Tencent,weui,24540,608,583,25
nylas,nylas-mail,24528,3421,2416,1005
wg,wrk,24525,310,222,88
dylanaraps,pure-bash-bible,24483,47,23,24
localstack,localstack,24461,1518,1281,237
select2,select2,24429,4461,4420,41
Modernizr,Modernizr,24354,1417,1261,156
google,styleguide,24338,226,77,149
johnpapa,angular-styleguide,24197,423,361,62
madewithml,lessons,24146,18,18,0
yangshun,front-end-interview-handbook,24122,0,0,0
carbon-app,carbon,24121,428,408,20
FiloSottile,mkcert,24071,170,133,37
TheAlgorithms,Java,24006,176,135,41
houshanren,hangzhou_house_knowledge,23943,0,0,0
nvie,gitflow,23912,335,114,221
fzaninotto,Faker,23897,542,486,56
astaxie,beego,23884,2702,1909,793
ngosang,trackerslist,23852,214,211,3
iina,iina,23748,2325,1458,867
vuejs,vuex,23743,991,959,32
standard,standard,23718,1075,966,109
ZuzooVn,machine-learning-for-software-engineers,23715,15,3,12
Alvin9999,new-pac,23683,877,690,187
iikira,BaiduPCS-Go,23656,925,793,132
nolimits4web,swiper,23624,3170,2996,174
ziadoz,awesome-php,23583,107,106,1
rethinkdb,rethinkdb,23582,6251,4854,1397
github,fetch,23563,498,488,10
Marak,faker.js,23547,428,241,187
pingcap,tidb,23513,4527,3088,1439
netty,netty,23508,5067,4691,376
jakevdp,PythonDataScienceHandbook,23476,114,46,68
herrbischoff,awesome-macos-command-line,23391,0,0,0
dkhamsing,open-source-ios-apps,23353,203,202,1
angular,angular-cli,23337,11707,11070,637
mathiasbynens,dotfiles,23273,354,228,126
jiahaog,nativefier,23245,784,610,174
iview,iview,23243,5425,4432,993
facebookresearch,Detectron,23233,883,603,280
symfony,symfony,23229,14009,13252,757
composer,composer,23028,5946,5590,356
freeCodeCamp,devdocs,23009,818,719,99
google-research,bert,22964,925,297,628
CodeHubApp,CodeHub,22887,606,392,214
tailwindcss,tailwindcss,22882,831,733,98
fxsjy,jieba,22872,691,186,505
raywenderlich,swift-algorithm-club,22858,184,174,10
istio,istio,22774,9670,8633,1037
danielgindi,Charts,22746,3626,3128,498
IanLunn,Hover,22742,96,79,17
lerna,lerna,22686,1777,1396,381
SDWebImage,SDWebImage,22661,1896,1874,22
postcss,postcss,22605,645,627,18
transloadit,uppy,22587,1110,1017,93
pi-hole,pi-hole,22581,1804,1682,122
serhii-londar,open-source-mac-os-apps,22550,127,113,14
brillout,awesome-react-components,22530,36,36,0
alacritty,alacritty,22519,2508,2148,360
greenrobot,EventBus,22474,520,432,88
GitbookIO,gitbook,22408,0,0,0
markedjs,marked,22349,986,907,79
lib-pku,libpku,22343,32,30,2
date-fns,date-fns,22302,909,755,154
gitlabhq,gitlabhq,22233,0,0,0
harvesthq,chosen,22187,2325,2105,220
skylot,jadx,22157,679,561,118
ityouknow,spring-boot-examples,22104,96,94,2
CSSEGISandData,COVID-19,22088,2075,768,1307
jaredpalmer,formik,22033,1604,1087,517
3b1b,manim,21962,590,388,202
hashicorp,terraform,21938,14672,13377,1295
cheeriojs,cheerio,21908,937,721,216
sequelize,sequelize,21880,8571,7772,799
ReactiveX,rxjs,21879,2558,2236,322
webtorrent,webtorrent,21841,1315,1164,151
mobxjs,mobx,21822,1506,1490,16
minio,minio,21806,4058,3968,90
geekcompany,ResumeSample,21678,0,0,0
VincentGarreau,particles.js,21631,331,71,260
alibaba,p3c,21622,590,545,45
sentsin,layui,21606,485,75,410
amix,vimrc,21557,404,404,0
Homebrew,brew,21531,2507,2495,12
rclone,rclone,21504,3227,2578,649
ajaxorg,ace,21493,2495,1835,660
naptha,tesseract.js,21466,358,341,17
emberjs,ember.js,21451,6250,6000,250
unknwon,the-way-to-go_ZH_CN,21413,0,0,0
Polymer,polymer,21404,3887,3638,249
balderdashy,sails,21333,6127,5770,357
alibaba,fastjson,21331,2627,1336,1291
hammerjs,hammer.js,21315,1005,753,252
ryanoasis,nerd-fonts,21287,345,224,121
VundleVim,Vundle.vim,21271,685,532,153
dcloudio,uni-app,21264,1535,1044,491
elsewhencode,project-guidelines,21241,36,24,12
tabler,tabler,21187,312,258,54
kelseyhightower,kubernetes-the-hard-way,21180,294,266,28
ycm-core,YouCompleteMe,21176,2850,2828,22
0xAX,linux-insides,21167,154,120,34
alibaba,druid,21163,2765,1071,1694
CamDavidsonPilon,Probabilistic-Programming-and-Bayesian-Methods-for-Hackers,21145,210,82,128
laravel,framework,21106,13617,13614,3
facebookresearch,fastText,21094,861,568,293
terryum,awesome-deep-learning-papers,21072,23,11,12
alibaba,arthas,21054,880,760,120
StreisandEffect,streisand,21039,1095,922,173
drone,drone,21026,1708,1678,30
SheetJS,sheetjs,20988,1698,1360,338
alibaba,flutter-go,20957,325,173,152
agalwood,Motrix,20956,541,300,241
rstacruz,nprogress,20929,133,46,87
tootsuite,mastodon,20895,5447,3915,1532
eugenp,tutorials,20850,375,361,14
microsoft,PowerToys,20846,2084,1182,902
realpython,python-guide,20830,246,151,95
cmderdev,cmder,20823,1863,1854,9
pure-css,pure,20817,534,532,2
NationalSecurityAgency,ghidra,20796,1494,835,659
heartcombo,devise,20793,3938,3884,54
Automattic,mongoose,20773,7423,7105,318
airbnb,lottie-web,20741,2033,1573,460
fouber,blog,20725,40,29,11
t4t5,sweetalert,20720,657,535,122
ctripcorp,apollo,20697,2008,1839,169
ocornut,imgui,20684,2550,2142,408
scwang90,SmartRefreshLayout,20674,1129,1045,84
satwikkansal,wtfpython,20667,107,81,26
metabase,metabase,20660,7151,5098,2053
google,leveldb,20637,574,471,103
openai,gym,20630,1108,1012,96
facebook,flow,20604,6290,3875,2415
remy,nodemon,20552,1290,1279,11
akveo,ngx-admin,20491,1540,1257,283
rapid7,metasploit-framework,20475,3845,3160,685
niklasvh,html2canvas,20441,1887,1308,579
redux-saga,redux-saga,20359,1314,1161,153
gorhill,uBlock,20342,3449,3377,72
littlecodersh,ItChat,20338,800,592,208
pypa,pipenv,20282,3021,2640,381
fighting41love,funNLP,20267,26,25,1
sorrycc,awesome-javascript,20249,71,54,17
codemirror,CodeMirror,20224,3670,3324,346
Tencent,wepy,20218,2019,1713,306
FezVrasta,bootstrap-material-design,20142,1083,1028,55
ggreer,the_silver_searcher,20114,740,388,352
vim,vim,20108,3627,2696,931
kriasoft,react-starter-kit,20098,1147,708,439
cypress-io,cypress,20084,5424,4220,1204
SortableJS,Sortable,20076,1399,1169,230
microsoft,monaco-editor,20009,1789,1427,362
dimsemenov,PhotoSwipe,20005,1516,1016,500
JedWatson,react-select,19999,2676,1474,1202
syl20bnr,spacemacs,19989,7344,5005,2339
wagoodman,dive,19978,187,134,53
ovity,octotree,19972,573,513,60
CymChad,BaseRecyclerViewAdapterHelper,19950,2919,2771,148
koalaman,shellcheck,19938,1673,1121,552
aria2,aria2,19933,1343,648,695
mbeaudru,modern-js-cheatsheet,19885,42,36,6
facebookarchive,pop,19843,255,211,44
hashicorp,vagrant,19836,8410,8002,408
donnemartin,interactive-coding-challenges,19822,52,29,23
GoogleChrome,lighthouse,19793,6784,6365,419
google,iosched,19782,199,170,29
ReactiveCocoa,ReactiveCocoa,19782,1988,1945,43
angular,components,19779,10883,8756,2127
bevacqua,dragula,19763,467,289,178
microsoft,calculator,19757,576,435,141
Meituan-Dianping,mpvue,19746,1659,1256,403
kahun,awesome-sysadmin,19740,92,21,71
Reactive-Extensions,RxJS,19737,874,643,231
ageron,handson-ml,19735,483,388,95
go-gitea,gitea,19717,5399,4114,1285
sharkdp,bat,19691,560,534,26
BurntSushi,ripgrep,19679,1070,1026,44
LisaDziuba,Awesome-Design-Tools,19679,24,21,3
sindresorhus,awesome-electron,19650,44,35,9
Netflix,Hystrix,19637,997,671,326
railsware,upterm,19635,753,534,219
github,hub,19616,1696,1505,191
SwiftyJSON,SwiftyJSON,19570,646,558,88
docker,compose,19547,4890,4559,331
airbnb,lottie-ios,19533,810,677,133
FFmpeg,FFmpeg,19507,0,0,0
reduxjs,react-redux,19446,1042,1019,23
SwiftGGTeam,the-swift-programming-language-in-chinese,19372,321,320,1
byoungd,English-level-up-tips-for-Chinese,19354,54,43,11
florinpop17,app-ideas,19353,18,7,11
alebcay,awesome-shell,19345,37,16,21
hankcs,HanLP,19341,1370,1363,7
liyasthomas,postwoman,19320,304,291,13
MunGell,awesome-for-beginners,19319,57,57,0
mochajs,mocha,19308,2509,2252,257
obsproject,obs-studio,19303,472,355,117
guzzle,guzzle,19282,1586,1356,230
pyenv,pyenv,19277,1089,906,183
BradLarson,GPUImage,19256,2199,1300,899
usablica,intro.js,19252,585,370,215
atlassian,react-beautiful-dnd,19250,1041,845,196
powerline,fonts,19234,223,81,142
markerikson,react-redux-links,19223,32,21,11
pugjs,pug,19210,2418,2201,217
kon9chunkit,GitHub-Chinese-Top-Charts,19168,91,28,63
matteocrippa,awesome-swift,19167,110,110,0
PowerShell,PowerShell,19142,7455,5048,2407
dokku,dokku,19119,2008,1973,35
hashicorp,consul,19118,3737,3155,582
jgm,pandoc,19108,5012,4444,568
petkaantonov,bluebird,19097,1113,1057,56
tornadoweb,tornado,19080,1565,1400,165
julycoding,The-Art-Of-Programming-By-July,19067,127,82,45
ColorlibHQ,gentelella,19065,618,605,13
MrRio,jsPDF,19064,1694,1490,204
tipsy,profile-summary-for-github,19063,65,54,11
jobbole,awesome-python-cn,19051,14,12,2
nefe,You-Dont-Need-jQuery,19045,64,57,7
emscripten-core,emscripten,19041,5274,4640,634
typeorm,typeorm,19016,4739,3051,1688
dmlc,xgboost,19012,3416,3190,226
FallibleInc,security-guide-for-developers,19003,11,4,7
bvaughn,react-virtualized,18999,958,684,274
googlehosts,hosts,18998,378,334,44
paularmstrong,normalizr,18946,279,264,15
ReactiveX,RxAndroid,18938,336,336,0
typicode,husky,18905,498,369,129
junegunn,vim-plug,18904,746,706,40
ramda,ramda,18870,1439,1252,187
futurice,android-best-practices,18866,83,61,22
influxdata,influxdb,18854,9858,9074,784
formulahendry,955.WLB,18799,182,59,123
SamyPesse,How-to-Make-a-Computer-Operating-System,18762,63,25,38
mitmproxy,mitmproxy,18747,2203,1940,263
enzymejs,enzyme,18723,1623,1404,219
jlmakes,scrollreveal,18708,453,444,9
chubin,cheat.sh,18691,121,60,61
apache,incubator-mxnet,18680,8913,7217,1696
domnikl,DesignPatternsPHP,18672,93,90,3
vapor,vapor,18654,1252,1209,43
react-native-elements,react-native-elements,18616,1422,1344,78
doczjs,docz,18579,1061,987,74
inconshreveable,ngrok,18579,592,372,220
Advanced-Frontend,Daily-Interview-Question,18570,354,199,155
google,web-starter-kit,18562,580,533,47
NativeScript,NativeScript,18523,5637,4998,639
donnemartin,data-science-ipython-notebooks,18448,27,19,8
lydiahallie,javascript-questions,18437,108,79,29
nlohmann,json,18418,1622,1590,32
Prinzhorn,skrollr,18417,776,533,243
ReactiveX,RxSwift,18414,1052,1023,29
postcss,autoprefixer,18409,1020,997,23
mqyqingfeng,Blog,18408,167,78,89
HeroTransitions,Hero,18363,542,372,170
verekia,js-stack-from-scratch,18352,156,118,38
jinzhu,gorm,18349,2425,1781,644
chenglou,react-motion,18316,386,241,145
segmentio,nightmare,18311,1206,1056,150
wsargent,docker-cheat-sheet,18274,27,22,5
lukasz-madon,awesome-remote-job,18231,37,35,2
trailofbits,algo,18222,1262,1199,63
kubernetes,minikube,18203,4354,3927,427
mattermost,mattermost-server,18200,4635,4260,375
nagadomi,waifu2x,18199,265,160,105
cockroachdb,cockroach,18193,24908,21733,3175
rollup,rollup,18164,2258,2073,185
kataras,iris,18125,542,526,16
ruanyf,es6tutorial,18105,470,470,0
react-navigation,react-navigation,18099,6896,6744,152
ftlabs,fastclick,18064,389,179,210
bcit-ci,CodeIgniter,18047,3108,3055,53
facebook,draft-js,18032,1501,895,606
feathericons,feather,18031,457,192,265
MostlyAdequate,mostly-adequate-guide,18011,227,185,42
dotnet,corefx,17892,0,0,0
avajs,ava,17887,1349,1199,150
mongodb,mongo,17877,0,0,0
fastai,fastai,17855,1035,1032,3
tj,commander.js,17842,669,657,12
veggiemonk,awesome-docker,17807,98,98,0
google,gson,17798,1263,850,413
bilibili,flv.js,17759,519,260,259
SnapKit,Masonry,17722,437,328,109
balena-io,etcher,17714,1404,1181,223
cfenollosa,os-tutorial,17701,81,50,31
tmux,tmux,17687,1868,1864,4
nsqio,nsq,17672,523,473,50
afollestad,material-dialogs,17670,1181,1141,40
Popmotion,popmotion,17666,544,534,10
swagger-api,swagger-ui,17664,4045,3555,490
xi-editor,xi-editor,17659,504,382,122
ipfs,ipfs,17658,202,202,0
SeleniumHQ,selenium,17657,6455,6057,398
JohnCoates,Aerial,17638,715,687,28
react-bootstrap,react-bootstrap,17591,2676,2584,92
pcottle,learnGitBranching,17584,316,283,33
QSCTech,zju-icicles,17574,32,26,6
alibaba,weex,17572,1845,1310,535
OAI,OpenAPI-Specification,17562,1444,1017,427
openfaas,faas,17562,681,617,64
pjreddie,darknet,17546,1922,457,1465
ianstormtaylor,slate,17525,2218,2033,185
jcjohnson,neural-style,17522,435,141,294
acmesh-official,acme.sh,17509,1691,1191,500
dhg,Skeleton,17492,193,122,71
ruanyf,jstraining,17464,41,41,0
square,picasso,17452,1499,1318,181
parse-community,parse-server,17448,3653,3558,95
odoo,odoo,17443,12337,11077,1260
Seldaek,monolog,17399,619,582,37
dotnet,aspnetcore,17382,15626,13320,2306
jaredhanson,passport,17372,642,323,319
jorgebucaran,hyperapp,17349,516,502,14
encode,django-rest-framework,17324,3427,3271,156
keon,algorithms,17309,114,77,37
CorentinJ,Real-Time-Voice-Cloning,17292,298,148,150
geekcomputers,Python,17234,119,53,66
vuejs,vue-devtools,17220,882,663,219
labstack,echo,17216,1000,969,31
komeiji-satori,Dress,17207,301,224,77
npm,npm,17197,18672,16505,2167
davideuler,architecture.of.internet-product,17192,10,3,7
CMU-Perceptual-Computing-Lab,openpose,17189,1340,1307,33
denysdovhan,wtfjs,17188,65,29,36
viatsko,awesome-vscode,17162,32,20,12
d2l-ai,d2l-zh,17138,0,0,0
sqlmapproject,sqlmap,17128,3878,3833,45
curl,curl,17117,2243,2213,30
helm,helm,17104,4541,4015,526
localForage,localForage,17085,615,460,155
felixrieseberg,windows95,17061,140,86,54
jamiebuilds,the-super-tiny-compiler,17026,0,0,0
android,architecture-components-samples,16999,555,453,102
prisma,prisma1,16996,3390,2879,511
Homebrew,homebrew-cask,16985,5384,5343,41
airyland,vux,16984,3224,2462,762
kelthuzadx,hosts,16984,891,888,3
react-spring,react-spring,16953,711,640,71
Wox-launcher,Wox,16949,2566,1789,777
sampotts,plyr,16945,1416,1004,412
tobiasahlin,SpinKit,16938,55,52,3
vlang,v,16937,2223,1673,550
TeamStuQ,skill-map,16937,79,13,66
stedolan,jq,16929,1658,1163,495
BoostIO,Boostnote,16920,2250,1821,429
go-kit,kit,16910,452,398,54
spf13,cobra,16898,566,399,167
libgdx,libgdx,16897,3130,2851,279
bannedbook,fanqiang,16895,480,299,181
elixir-lang,elixir,16882,4060,4043,17
kilimchoi,engineering-blogs,16867,76,75,1
jgraph,drawio,16864,815,556,259
facebook,docusaurus,16862,898,786,112
google,python-fire,16846,166,112,54
nikitavoloboev,my-mac-os,16825,70,68,2
ruby,ruby,16810,0,0,0
yeasy,docker_practice,16783,176,172,4
microsoft,CNTK,16772,3243,2506,737
osquery,osquery,16765,2450,1830,620
chrisbanes,PhotoView,16716,615,468,147
nostra13,Android-Universal-Image-Loader,16714,1205,770,435
matterport,Mask_RCNN,16701,1967,638,1329
facebook,flux,16694,228,216,12
apache,airflow,16693,1132,825,307
reduxjs,reselect,16658,297,234,63
hasura,graphql-engine,16652,2506,1675,831
defunkt,jquery-pjax,16636,441,386,55
facebook,rocksdb,16616,1929,1584,345
julianshapiro,velocity,16605,801,763,38
yunjey,pytorch-tutorial,16588,154,109,45
angular,material,16587,8927,8504,423
facebook,hhvm,16538,5719,4895,824
lovell,sharp,16538,1960,1869,91
necolas,react-native-web,16534,1183,1096,87
fengdu78,Coursera-ML-AndrewNg-Notes,16493,45,10,35
git-tips,tips,16490,27,16,11
benweet,stackedit,16457,1509,962,547
SnapKit,SnapKit,16418,485,417,68
immerjs,immer,16417,369,345,24
highlightjs,highlight.js,16393,1333,1292,41
explosion,spaCy,16381,3943,3756,187
eslint,eslint,16367,7852,7710,142
InterviewMap,CS-Interview-Knowledge-Map,16360,101,74,27
vuejs,vuepress,16329,1441,1190,251
rwaldron,idiomatic.js,16314,75,44,31
ApolloAuto,apollo,16311,2277,1664,613
gfwlist,gfwlist,16310,1927,1393,534
less,less.js,16301,2645,2498,147
mbadolato,iTerm2-Color-Schemes,16290,57,47,10
vuejs,vue-router,16287,2392,2277,115
jesseduffield,lazygit,16271,434,327,107
Micropoor,Micro8,16236,40,30,10
adobe-fonts,source-code-pro,16227,186,142,44
lenve,vhr,16195,189,81,108
wekan,wekan,16187,2297,1735,562
goldfire,howler.js,16184,1112,767,345
sebastianbergmann,phpunit,16177,2687,2586,101
facebook,fresco,16160,2099,1995,104
palantir,blueprint,16122,2101,1614,487
getredash,redash,16116,1892,1515,377
onevcat,Kingfisher,16086,935,881,54
jhipster,generator-jhipster,16079,5812,5716,96
twitter,typeahead.js,16067,1314,903,411
graphql,graphql-js,16064,821,742,79
eriklindernoren,ML-From-Scratch,16004,53,33,20
psf,black,15975,973,708,265
nicolargo,glances,15940,1205,1050,155
servo,servo,15936,10967,7813,3154
wenyan-lang,wenyan,15913,436,285,151
reactnativecn,react-native-guide,15882,19,18,1
JacksonTian,fks,15831,26,17,9
zeit,pkg,15823,805,316,489
fabricjs,fabric.js,15822,4538,4315,223
drduh,macOS-Security-and-Privacy-Guide,15811,216,213,3
laurent22,joplin,15752,2282,2087,195
uikit,uikit,15735,3672,3111,561
qiurunze123,miaosha,15733,43,29,14
ElemeFE,mint-ui,15733,1213,980,233
mojs,mojs,15728,174,119,55
apache,kafka,15721,0,0,0
judasn,IntelliJ-IDEA-Tutorial,15719,67,66,1
marktext,marktext,15707,1322,995,327
alsotang,node-lessons,15698,125,43,82
hashicorp,vault,15698,3610,3112,498
HelloZeroNet,ZeroNet,15688,1957,1344,613
jtoy,awesome-tensorflow,15673,10,10,0
uglide,RedisDesktopManager,15670,4279,4240,39
Kotlin,anko,15658,616,378,238
jdg,MBProgressHUD,15629,378,334,44
zhaoolee,ChromeAppHeroes,15614,36,27,9
sebastianruder,NLP-progress,15567,79,59,20
swoole,swoole-src,15559,2385,2344,41
nosir,cleave.js,15559,417,316,101
seata,seata,15553,1419,1159,260
js-cookie,js-cookie,15547,412,408,4
jashkenas,coffeescript,15540,4056,4020,36
google,flexbox-layout,15525,270,200,70
hubotio,hubot,15509,747,683,64
validatorjs,validator.js,15509,678,582,96
google,ExoPlayer,15499,6483,6069,414
iptv-org,iptv,15483,274,219,55
jenkinsci,jenkins,15462,0,0,0
eggjs,egg,15430,3245,3116,129
framework7io,framework7,15430,3039,2942,97
MLEveryday,100-Days-Of-ML-Code,15418,47,38,9
mysqljs,mysql,15418,1963,1839,124
google,googletest,15412,1484,1341,143
winstonjs,winston,15373,1150,859,291
reddit-archive,reddit,15372,0,0,0
YMFE,yapi,15344,1601,741,860
shuzheng,zheng,15340,89,60,29
handlebars-lang,handlebars.js,15319,1223,1178,45
1c7,chinese-independent-developer,15319,52,50,2
android,plaid,15314,331,271,60
rubocop-hq,ruby-style-guide,15296,291,228,63
rust-unofficial,awesome-rust,15285,81,68,13
StevenBlack,hosts,15276,878,843,35
FelisCatus,SwitchyOmega,15247,2002,1632,370
iissnan,hexo-theme-next,15222,1834,1774,60
phoenixframework,phoenix,15222,1879,1868,11
Binaryify,NeteaseCloudMusicApi,15172,687,663,24
bower,bower,15143,1897,1892,5
ChristosChristofidis,awesome-deep-learning,15120,13,13,0
libuv,libuv,15093,1192,1121,71
visionmedia,superagent,15092,958,837,121
v8,v8,15074,0,0,0
wangzheng0822,algo,15072,101,17,84
ruanyf,react-demos,15072,27,27,0
tensorflow,magenta,15055,684,463,221
halo-dev,halo,15054,565,502,63
commaai,openpilot,15049,438,409,29
jamiebuilds,react-loadable,15043,0,0,0
ipader,SwiftGuide,15038,27,27,0
alibaba,ice,15033,1349,1325,24
fish-shell,fish-shell,15026,5002,4521,481
golang-standards,project-layout,15023,42,9,33
statsd,statsd,15018,258,217,41
facebook,folly,15012,673,494,179
jesseduffield,lazydocker,15012,131,72,59
basecamp,trix,15005,601,560,41
Tencent,tinker,15001,1280,997,283
poteto,hiring-without-whiteboards,14975,0,0,0
celery,celery,14952,4112,3719,393
enyo,dropzone,14947,0,0,0
datasciencemasters,go,14942,45,22,23
PHPMailer,PHPMailer,14936,1567,1515,52
notable,notable,14927,1063,749,314
jeromeetienne,AR.js,14902,624,619,5
popperjs,popper-core,14885,618,616,2
n0shake,Public-APIs,14860,35,31,4
HubSpot,pace,14850,418,139,279
keystonejs,keystone-classic,14839,2447,2151,296
kriskowal,q,14818,547,447,100
chaozh,awesome-blockchain-cn,14813,25,18,7
sindresorhus,quick-look-plugins,14813,78,72,6
sirupsen,logrus,14807,515,439,76
hapijs,joi,14803,1820,1798,22
jasmine,jasmine,14789,1255,1193,62
crystal-lang,crystal,14786,5090,4219,871
madrobby,zepto,14747,747,678,69
designmodo,Flat-UI,14719,188,179,9
dvajs,dva,14717,2035,1999,36
cjbarber,ToolsOfTheTrade,14717,37,36,1
electron-react-boilerplate,electron-react-boilerplate,14667,1161,1131,30
nostalgic-css,NES.css,14659,151,130,21
dwmkerr,hacker-laws,14653,128,40,88
bazelbuild,bazel,14651,7654,5738,1916
angular-ui,bootstrap,14650,4455,4185,270
desandro,masonry,14631,1075,1044,31
Developer-Y,cs-video-courses,14627,21,18,3
quasarframework,quasar,14626,4387,4199,188
iview,iview-admin,14622,1156,606,550
joewalnes,websocketd,14612,275,250,25
portainer,portainer,14608,2570,1988,582
wagerfield,parallax,14608,244,200,44
reduxjs,redux-thunk,14605,182,180,2
alibaba,easyexcel,14601,1200,1186,14
nuysoft,Mock,14595,371,131,240
swisskyrepo,PayloadsAllTheThings,14585,43,36,7
shieldfy,API-Security-Checklist,14586,29,19,10
oxford-cs-deepnlp-2017,lectures,14568,16,6,10
hollischuang,toBeTopJavaer,14559,37,27,10
zziz,pwc,14549,19,4,15
microsoft,MS-DOS,14541,52,49,3
tsenart,vegeta,14514,321,287,34
microsoft,api-guidelines,14512,77,53,24
wuyouzhuguli,SpringAll,14505,29,22,7
acdlite,recompose,14504,427,373,54
tqdm,tqdm,14490,629,416,213
facebook,relay,14488,1573,1383,190
ionic-team,ionicons,14478,710,390,320
nswbmw,N-blog,14461,434,419,15
chalk,chalk,14459,262,252,10
yabwe,medium-editor,14459,898,600,298
AllThingsSmitty,css-protips,14447,43,39,4
0xd4d,dnSpy,14430,1362,1228,134
Tencent,mars,14412,699,530,169
twbs,ratchet,14408,536,334,202
machinelearningmindset,TensorFlow-Course,14407,10,10,0
spf13,spf13-vim,14391,720,409,311
homebridge,homebridge,14386,2243,2224,19
libra,libra,14381,692,450,242
PostgREST,postgrest,14377,933,836,97
briannesbitt,Carbon,14366,902,894,8
fastify,fastify,14363,892,845,47
didi,DoraemonKit,14361,334,312,22
cocos2d,cocos2d-x,14360,4775,3496,1279
material-components,material-components-web,14352,2472,2177,295
airbnb,react-sketchapp,14350,287,263,24
limetext,lime,14341,401,380,21
binux,pyspider,14334,791,541,250
altercation,solarized,14328,244,95,149
google,flatbuffers,14313,1327,1126,201
dennybritz,reinforcement-learning,14307,141,56,85
infernojs,inferno,14301,815,782,33
mxgmn,WaveFunctionCollapse,14294,36,33,3
leereilly,games,14275,198,75,123
charlax,professional-programming,14272,7,7,0
adam-golab,react-developer-roadmap,14264,38,18,20
hackiftekhar,IQKeyboardManager,14262,1543,1508,35
android10,Android-CleanArchitecture,14255,246,121,125
rancher,rancher,14254,22344,19661,2683
elastic,kibana,14207,24518,18112,6406
riot,riot,14203,2086,2082,4
hzlzh,Best-App,14182,65,30,35
ipython,ipython,14179,6349,5050,1299
braydie,HowToBeAProgrammer,14172,21,17,4
Shopify,draggable,14156,225,123,102
eligrey,FileSaver.js,14117,513,433,80
svg,svgo,14108,899,626,273
jsdom,jsdom,14086,1784,1493,291
google,eng-practices,14086,4,2,2
facebook,prepack,14081,767,561,206
xkcoding,spring-boot-demo,14055,89,52,37
iperov,DeepFaceLab,14047,649,585,64
trekhleb,homemade-machine-learning,14022,18,7,11
CarGuo,GSYVideoPlayer,14018,2607,2591,16
DrKLO,Telegram,13995,0,0,0
websockets,ws,13977,1154,1147,7
PKUanonym,REKCARC-TSC-UHT,13973,17,9,8
recharts,recharts,13973,1795,1703,92
Eugeny,terminus,13954,1480,1144,336
luong-komorebi,Awesome-Linux-Software,13931,99,92,7
mozilla,DeepSpeech,13929,1679,1608,71
tj,git-extras,13914,305,219,86
wangshub,wechat_jump_game,13913,984,958,26
go-delve,delve,13898,1069,972,97
yudai,gotty,13898,192,118,74
dotnet-architecture,eShopOnContainers,13891,850,800,50
xuxueli,xxl-job,13887,1456,1353,103
realm,realm-cocoa,13861,3957,3503,454
fbsamples,f8app,13860,203,187,16
janl,mustache.js,13845,427,373,54
angular-ui,ui-router,13842,3160,3146,14
WordPress,WordPress,13824,0,0,0
apollographql,apollo-client,13810,2739,2207,532
ccxt,ccxt,13795,4427,4104,323
SpaceVim,SpaceVim,13789,1729,1673,56
alibaba,canal,13785,2336,1875,461
GeekyAnts,NativeBase,13769,2443,2225,218
huge-success,sanic,13768,873,820,53
youzan,vant,13717,3918,3896,22
PerfectlySoft,Perfect,13709,183,134,49
vim-airline,vim-airline,13696,1474,1451,23
tiangolo,fastapi,13692,986,797,189
Carthage,Carthage,13692,1874,1726,148
menzi11,BullshitGenerator,13691,139,27,112
numpy,numpy,13690,8450,6582,1868
urfave,cli,13679,518,446,72
norvig,pytudes,13659,20,10,10
MengTo,Spring,13636,220,88,132
FormidableLabs,webpack-dashboard,13634,206,173,33
ampproject,amphtml,13630,10815,9005,1810
css-modules,css-modules,13600,304,218,86
yaronn,blessed-contrib,13599,113,58,55
Awesome-HarmonyOS,HarmonyOS,13593,0,0,0
dotnet,core,13582,3222,2997,225
apache,incubator-weex,13565,843,690,153
hemanth,functional-programming-jargon,13562,63,42,21
docsifyjs,docsify,13560,790,676,114
hwdsl2,setup-ipsec-vpn,13548,738,733,5
getlantern,download,13544,0,0,0
handsontable,handsontable,13537,5912,5111,801
viraptor,reverse-interview,13529,17,11,6
pshihn,rough,13522,96,89,7
react-dnd,react-dnd,13520,1234,1116,118
30-seconds,30-seconds-of-css,13514,57,57,0
ibireme,YYKit,13505,483,240,243
alibaba,spring-cloud-alibaba,13498,921,695,226
preservim,nerdtree,13480,763,751,12
TKkk-iOSer,WeChatPlugin-MacOS,13479,554,423,131
toml-lang,toml,13477,361,331,30
Awesome-Windows,Awesome,13477,68,63,5
mybatis,mybatis-3,13463,990,880,110
Kong,insomnia,13461,1647,1310,337
fivethirtyeight,data,13449,102,73,29
amazeui,amazeui,13442,700,564,136
cool-RR,PySnooper,13440,96,81,15
geeeeeeeeek,electronic-wechat,13434,594,397,197
sharkdp,fd,13400,356,332,24
dbeaver,dbeaver,13400,7950,6652,1298
cayleygraph,cayley,13381,459,389,70
realm,SwiftLint,13372,1633,1279,354
yiisoft,yii2,13366,10622,10157,465
bokeh,bokeh,13365,5896,5383,513
you-dont-need,You-Dont-Need-JavaScript,13364,34,9,25
aFarkas,lazysizes,13359,672,545,127
source-foundry,Hack,13341,430,333,97
angular,angular-seed,13339,213,204,9
cmusatyalab,openface,13330,367,364,3
oblador,react-native-vector-icons,13329,933,693,240
apache,skywalking,13325,2297,2207,90
facebookarchive,AsyncDisplayKit,13322,1365,1343,22
ccgus,fmdb,13321,526,309,217
interagent,http-api-design,13318,46,17,29
so-fancy,diff-so-fancy,13318,214,203,11
zsh-users,zsh-autosuggestions,13300,379,348,31
lgvalle,Material-Animations,13298,40,27,13
kailashahirwar,cheatsheets-ai,13294,14,8,6
google,fonts,13294,1262,582,680
haoel,leetcode,13290,50,34,16
spotify,luigi,13288,838,798,40
dianping,cat,13287,993,943,50
frappe,charts,13274,191,98,93
bitcoinbook,bitcoinbook,13274,264,207,57
prisma-archive,chromeless,13265,332,160,172
pubkey,rxdb,13245,368,365,3
ty4z2008,Qix,13237,21,20,1
vadimdemedes,ink,13227,158,118,40
philc,vimium,13221,2607,1925,682
vurtun,nuklear,13219,659,451,208
tensorflow,tfjs,13218,2098,1662,436
browserify,browserify,13195,1415,1098,317
golang,dep,13187,1351,1087,264
nfl,react-helmet,13184,322,203,119
CoderMJLee,MJRefresh,13180,1247,1222,25
ethereum,wiki,13176,321,303,18
marcuswestin,WebViewJavascriptBridge,13175,263,197,66
salomonelli,best-resume-ever,13171,114,92,22
zyedidia,micro,13165,1169,866,303
facebook,yoga,13148,460,262,198
helm,charts,13147,5634,5351,283
dgraph-io,dgraph,13145,2176,1916,260
strongloop,loopback,13132,3252,3248,4
tj,n,13117,405,401,4
nginx-proxy,nginx-proxy,13107,1050,539,511
processing,p5.js,13096,2641,2548,93
substack,stream-handbook,13089,46,11,35
matomo-org,matomo,13080,10890,9183,1707
pouchdb,pouchdb,13072,3889,3844,45
hdodenhof,CircleImageView,13068,328,325,3
nikic,PHP-Parser,13063,411,367,44
redisson,redisson,13062,2457,2324,133
signalapp,Signal-Android,13061,7429,6889,540
envoyproxy,envoy,13050,3822,3107,715
sqlitebrowser,sqlitebrowser,13041,1820,1436,384
geeeeeeeeek,git-recipes,13031,0,0,0
maxwellito,vivus,13024,179,172,7
typescript-cheatsheets,react-typescript-cheatsheet,13016,90,60,30
