freeCodeCamp,310521,14381,14194,187,"[1, 3, 4, 6, 11, 15, 17, 18, 19, 20, 24, 25, 28, 29, 31, 32, 40, 42, 43, 44, 46, 48, 49, 53, 54, 56, 59, 60, 63, 67, 71, 72, 75, 76, 78, 79, 80, 83, 84, 89, 96, 103, 105, 107, 108, 111, 112, 113, 115, 121, 122, 123, 124, 125, 126, 127, 129, 130, 131, 132, 133, 134, 135, 136, 137, 138, 139, 140, 141, 142, 143, 144, 145, 146, 147, 148, 150, 151, 152, 154, 155, 156, 157, 158, 159, 160, 162, 163, 164, 165, 170, 171, 172, 173, 174, 175, 176, 179, 181, 182]"
996.ICU,249387,0,0,0,[]
vue,163389,8979,8666,313,"[1, 2, 3, 4, 5, 6, 7, 8, 9, 10, 11, 12, 13, 14, 15, 16, 17, 18, 19, 20, 21, 22, 23, 24, 25, 26, 27, 28, 29, 30, 31, 32, 33, 34, 35, 36, 37, 38, 39, 40, 41, 42, 43, 44, 45, 46, 47, 48, 49, 50, 51, 52, 53, 54, 55, 56, 57, 58, 59, 60, 61, 62, 63, 64, 65, 66, 67, 68, 69, 71, 72, 73, 74, 75, 76, 77, 78, 79, 80, 81, 82, 83, 84, 85, 86, 87, 88, 93, 95, 96, 97, 98, 99, 100, 101, 102, 103, 104, 105, 106]"
react,148144,9101,8613,488,"[10, 12, 16, 21, 24, 26, 28, 37, 39, 40, 47, 50, 60, 64, 65, 70, 71, 74, 76, 78, 79, 80, 82, 83, 90, 94, 98, 100, 101, 104, 111, 114, 116, 118, 119, 121, 122, 125, 127, 129, 130, 131, 133, 134, 137, 138, 140, 142, 146, 149, 152, 154, 155, 158, 159, 161, 162, 163, 164, 165, 166, 169, 170, 171, 174, 175, 179, 180, 181, 182, 183, 184, 185, 189, 191, 192, 198, 208, 215, 219, 221, 222, 226, 227, 229, 231, 234, 235, 238, 239, 240, 242, 244, 247, 248, 250, 253, 255, 256, 257]"
free-programming-books,146723,427,400,27,"[5, 38, 47, 72, 100, 117, 118, 123, 148, 185, 190, 201, 215, 233, 341, 375, 379, 395, 419, 449, 472, 489, 505, 526, 534, 535, 542, 555, 562, 603, 612, 619, 636, 653, 654, 661, 680, 688, 692, 699, 700, 701, 702, 703, 704, 705, 706, 707, 708, 709, 710, 711, 712, 713, 714, 715, 716, 717, 718, 719, 720, 721, 722, 723, 724, 725, 726, 727, 728, 729, 730, 731, 732, 733, 734, 735, 736, 737, 738, 739, 740, 749, 761, 766, 768, 769, 770, 771, 772, 773, 774, 775, 776, 777, 778, 779, 780, 781, 782, 783]"
tensorflow,143954,24760,21437,3323,"[1, 2, 3, 4, 5, 6, 7, 8, 9, 10, 11, 12, 14, 15, 16, 17, 18, 19, 20, 21, 22, 23, 24, 25, 26, 27, 28, 29, 30, 31, 32, 33, 34, 35, 36, 37, 39, 40, 41, 42, 43, 44, 45, 46, 47, 48, 49, 50, 51, 52, 53, 54, 56, 57, 58, 59, 61, 62, 63, 64, 65, 66, 67, 68, 69, 70, 71, 72, 73, 74, 75, 76, 77, 78, 79, 80, 81, 82, 83, 84, 85, 86, 88, 89, 91, 92, 93, 94, 95, 96, 97, 98, 100, 101, 103, 104, 105, 106, 107, 108]"
bootstrap,140541,19234,18928,306,"[2, 4, 5, 6, 7, 9, 10, 11, 13, 14, 15, 17, 18, 19, 20, 22, 23, 24, 25, 29, 31, 32, 33, 34, 36, 38, 39, 41, 42, 43, 44, 46, 47, 48, 49, 50, 52, 53, 54, 56, 57, 60, 61, 62, 63, 64, 65, 66, 67, 68, 72, 73, 74, 75, 76, 77, 78, 79, 80, 81, 82, 83, 84, 85, 86, 88, 90, 92, 93, 95, 97, 98, 99, 100, 101, 102, 103, 104, 105, 108, 109, 110, 111, 113, 116, 117, 118, 119, 123, 127, 128, 129, 130, 133, 135, 136, 137, 139, 140, 142]"
awesome,132483,249,235,14,"[5, 20, 33, 51, 73, 107, 112, 114, 118, 128, 129, 130, 138, 143, 147, 151, 153, 157, 167, 177, 184, 187, 188, 200, 206, 207, 213, 216, 219, 222, 227, 228, 229, 230, 232, 253, 254, 258, 266, 269, 289, 291, 298, 304, 323, 340, 349, 360, 365, 409, 410, 414, 418, 424, 427, 435, 444, 470, 477, 479, 501, 504, 516, 517, 537, 544, 548, 550, 556, 569, 592, 621, 623, 628, 633, 643, 650, 661, 663, 671, 677, 683, 685, 687, 693, 699, 703, 709, 714, 717, 718, 731, 732, 736, 748, 752, 757, 767, 772, 784]"
You-Dont-Know-JS,120844,832,759,73,"[3, 9, 11, 12, 22, 23, 25, 26, 28, 29, 30, 31, 32, 33, 34, 35, 36, 37, 38, 39, 40, 41, 42, 43, 44, 45, 47, 48, 49, 50, 52, 54, 55, 56, 57, 58, 59, 60, 62, 63, 65, 66, 67, 69, 71, 73, 74, 75, 77, 79, 86, 87, 90, 91, 92, 93, 94, 95, 98, 99, 100, 101, 102, 103, 104, 106, 107, 108, 109, 110, 111, 112, 113, 115, 116, 117, 118, 119, 120, 122, 123, 124, 125, 126, 130, 134, 135, 136, 137, 138, 139, 140, 141, 143, 150, 151, 152, 153, 154, 155]"
coding-interview-university,112350,112,85,27,"[5, 7, 8, 13, 21, 24, 25, 26, 30, 33, 39, 40, 54, 60, 64, 70, 73, 74, 80, 81, 82, 87, 89, 90, 92, 96, 97, 98, 99, 101, 104, 106, 113, 117, 118, 122, 124, 125, 130, 131, 135, 140, 156, 166, 169, 170, 172, 174, 182, 183, 184, 186, 195, 202, 209, 211, 219, 229, 239, 241, 243, 253, 257, 259, 271, 275, 277, 279, 280, 282, 286, 294, 307, 308, 312, 316, 318, 325, 328, 334, 344, 348, 358, 368, 374, 383, 384, 385, 386, 396, 398, 400, 401, 403, 404, 413, 414, 419, 429, 433]"
ohmyzsh,109242,3315,3087,228,"[1, 2, 3, 4, 5, 6, 7, 8, 9, 10, 11, 12, 13, 14, 15, 16, 17, 18, 19, 20, 21, 22, 23, 24, 25, 26, 27, 28, 29, 30, 31, 32, 33, 34, 35, 36, 37, 38, 39, 40, 41, 42, 43, 44, 45, 46, 47, 48, 49, 50, 51, 52, 53, 54, 55, 56, 57, 58, 59, 60, 61, 62, 63, 77, 79, 86, 95, 97, 115, 116, 130, 137, 140, 142, 146, 160, 189, 193, 227, 234, 237, 238, 240, 247, 248, 252, 262, 280, 282, 296, 301, 304, 309, 320, 323, 326, 331, 332, 333, 342]"
developer-roadmap,107062,418,405,13,"[1, 2, 3, 4, 5, 6, 8, 9, 10, 11, 12, 13, 15, 16, 17, 18, 19, 20, 21, 23, 24, 26, 27, 28, 29, 30, 31, 32, 34, 37, 38, 39, 40, 41, 42, 43, 44, 46, 49, 50, 51, 52, 53, 54, 55, 56, 57, 58, 60, 62, 64, 65, 66, 67, 68, 70, 72, 73, 75, 76, 77, 78, 82, 83, 85, 86, 87, 89, 90, 92, 93, 95, 96, 97, 99, 100, 101, 102, 103, 105, 106, 108, 109, 110, 112, 113, 117, 119, 121, 123, 124, 126, 127, 129, 130, 131, 132, 133, 134, 135]"
gitignore,100989,0,0,0,[]
CS-Notes,100060,396,367,29,"[1, 3, 4, 5, 8, 11, 13, 15, 25, 26, 27, 30, 33, 35, 39, 40, 42, 43, 44, 48, 49, 52, 53, 54, 55, 56, 60, 61, 62, 63, 65, 66, 67, 69, 73, 74, 77, 79, 80, 83, 85, 86, 87, 90, 91, 92, 93, 94, 95, 96, 97, 103, 105, 106, 108, 110, 111, 113, 119, 121, 123, 124, 126, 128, 130, 132, 133, 138, 140, 142, 143, 145, 146, 147, 149, 151, 152, 153, 154, 155, 156, 158, 159, 160, 161, 162, 163, 168, 179, 181, 182, 183, 185, 187, 189, 190, 191, 193, 194, 196]"
vscode,95778,88600,83882,4718,"[1, 2, 3, 4, 5, 6, 7, 8, 9, 10, 12, 13, 14, 15, 16, 17, 18, 19, 20, 21, 22, 23, 24, 26, 27, 28, 29, 30, 31, 32, 33, 34, 35, 36, 37, 38, 39, 40, 41, 42, 44, 46, 47, 48, 50, 51, 52, 53, 54, 55, 56, 57, 58, 59, 60, 62, 63, 64, 65, 66, 67, 68, 69, 71, 73, 74, 75, 76, 77, 78, 79, 80, 81, 82, 84, 85, 86, 87, 88, 89, 90, 91, 92, 93, 94, 95, 96, 98, 99, 100, 101, 102, 103, 104, 105, 106, 107, 108, 109, 110]"
javascript,95104,980,902,78,"[4, 8, 9, 13, 15, 18, 19, 21, 22, 24, 25, 27, 31, 32, 39, 40, 41, 42, 44, 52, 54, 55, 58, 60, 61, 62, 64, 67, 68, 69, 70, 71, 72, 74, 75, 80, 81, 84, 90, 92, 94, 96, 97, 98, 100, 101, 102, 105, 109, 110, 111, 112, 115, 118, 124, 128, 133, 136, 145, 157, 168, 173, 178, 180, 183, 189, 191, 192, 193, 196, 198, 207, 208, 211, 216, 221, 223, 225, 228, 231, 233, 240, 243, 244, 245, 247, 251, 257, 259, 263, 269, 273, 275, 280, 281, 285, 287, 294, 296, 297]"
system-design-primer,93647,116,33,83,"[1, 2, 3, 4, 6, 7, 12, 15, 16, 27, 28, 31, 32, 38, 39, 40, 41, 42, 43, 44, 45, 53, 54, 58, 63, 66, 68, 77, 79, 86, 87, 88, 90, 100, 102, 104, 107, 110, 126, 127, 130, 134, 136, 138, 148, 150, 164, 170, 171, 172, 175, 179, 181, 186, 187, 193, 195, 198, 201, 203, 211, 214, 219, 220, 222, 223, 225, 228, 234, 235, 236, 243, 244, 248, 249, 250, 254, 256, 265, 267, 271, 272, 274, 277, 278, 281, 284, 285, 288, 291, 309, 311, 313, 322, 326, 334, 335, 337, 338, 339]"
flutter,91807,36405,28910,7495,"[4, 5, 6, 7, 9, 12, 16, 20, 21, 22, 23, 24, 25, 26, 27, 39, 40, 41, 42, 43, 44, 45, 46, 47, 49, 50, 53, 54, 55, 56, 57, 59, 60, 63, 64, 67, 68, 69, 70, 71, 72, 73, 74, 75, 76, 77, 78, 79, 80, 81, 82, 83, 84, 85, 86, 88, 89, 90, 91, 92, 93, 94, 95, 96, 97, 98, 99, 100, 101, 102, 103, 104, 105, 106, 107, 108, 109, 110, 111, 112, 113, 114, 115, 116, 117, 118, 119, 120, 121, 122, 123, 124, 125, 126, 127, 128, 129, 130, 131, 132]"
d3,91310,2034,2030,4,"[1, 2, 3, 4, 5, 6, 7, 8, 9, 10, 11, 12, 13, 14, 15, 16, 17, 18, 19, 20, 21, 22, 23, 24, 25, 26, 27, 28, 29, 32, 33, 34, 35, 36, 37, 39, 40, 42, 43, 44, 45, 46, 47, 48, 49, 50, 51, 52, 54, 55, 57, 58, 59, 60, 61, 62, 65, 66, 67, 71, 72, 73, 76, 77, 78, 79, 80, 81, 82, 83, 84, 85, 87, 88, 90, 91, 92, 94, 96, 97, 98, 99, 100, 102, 103, 104, 108, 114, 115, 118, 119, 120, 121, 122, 128, 130, 136, 137, 138, 145]"
linux,90553,0,0,0,[]
react-native,86964,19316,18581,735,"[2, 4, 5, 7, 8, 9, 10, 11, 12, 14, 16, 17, 20, 22, 23, 24, 25, 26, 28, 29, 30, 31, 32, 33, 34, 35, 36, 38, 39, 40, 41, 42, 43, 44, 45, 46, 47, 48, 51, 52, 53, 54, 55, 56, 57, 60, 62, 63, 65, 68, 69, 70, 71, 72, 74, 75, 78, 79, 80, 84, 86, 88, 89, 90, 91, 92, 93, 94, 97, 98, 99, 101, 103, 105, 107, 108, 110, 111, 113, 114, 116, 118, 119, 120, 121, 122, 125, 126, 127, 128, 130, 131, 132, 133, 134, 136, 138, 140, 141, 143]"
Python-100-Days,84688,342,65,277,"[1, 2, 3, 4, 5, 7, 9, 10, 11, 12, 13, 16, 17, 18, 20, 21, 22, 23, 24, 29, 30, 31, 33, 34, 35, 36, 37, 38, 39, 40, 43, 44, 46, 47, 48, 49, 50, 51, 52, 53, 59, 60, 61, 62, 63, 65, 66, 67, 68, 71, 72, 73, 74, 76, 78, 79, 80, 81, 82, 83, 84, 89, 90, 91, 92, 93, 94, 95, 96, 97, 98, 100, 103, 104, 105, 108, 109, 111, 115, 116, 117, 118, 120, 121, 122, 127, 128, 131, 132, 134, 137, 138, 139, 142, 144, 148, 150, 155, 156, 157]"
electron,82458,12864,11749,1115,"[1, 2, 3, 4, 5, 6, 7, 8, 9, 10, 11, 12, 13, 14, 15, 16, 17, 18, 19, 20, 21, 22, 23, 24, 25, 26, 27, 28, 30, 31, 32, 33, 34, 35, 36, 37, 38, 39, 40, 41, 42, 43, 44, 45, 46, 47, 48, 49, 50, 51, 52, 53, 54, 55, 57, 59, 60, 61, 62, 63, 64, 66, 68, 70, 72, 73, 74, 75, 76, 77, 78, 80, 82, 83, 86, 87, 88, 89, 90, 94, 95, 96, 97, 98, 99, 102, 106, 107, 108, 109, 111, 112, 113, 114, 115, 116, 117, 118, 119, 120]"
awesome-python,82130,166,165,1,"[14, 24, 43, 48, 57, 70, 99, 102, 103, 121, 136, 137, 153, 159, 164, 169, 198, 233, 257, 262, 281, 282, 283, 292, 299, 316, 328, 337, 361, 362, 363, 374, 375, 382, 384, 385, 394, 405, 435, 436, 446, 456, 457, 458, 466, 473, 489, 521, 532, 536, 545, 548, 552, 558, 579, 592, 597, 599, 612, 625, 629, 648, 649, 668, 670, 680, 700, 705, 706, 714, 715, 732, 737, 742, 745, 764, 777, 785, 789, 803, 806, 807, 812, 815, 818, 819, 820, 821, 833, 841, 883, 906, 924, 941, 970, 1009, 1015, 1024, 1026, 1027]"
public-apis,80841,128,123,5,"[5, 11, 33, 38, 58, 69, 72, 81, 98, 99, 118, 119, 127, 139, 140, 155, 159, 189, 191, 193, 195, 203, 222, 249, 269, 284, 285, 293, 297, 303, 307, 308, 335, 339, 344, 348, 354, 375, 377, 400, 413, 425, 429, 430, 437, 443, 451, 453, 455, 460, 461, 475, 481, 511, 521, 541, 542, 543, 555, 575, 583, 588, 601, 616, 617, 633, 644, 646, 648, 657, 664, 671, 673, 720, 727, 729, 730, 736, 747, 750, 758, 792, 802, 813, 818, 820, 821, 845, 846, 856, 870, 877, 882, 883, 895, 913, 918, 930, 933, 935]"
create-react-app,78443,5768,5274,494,"[7, 9, 10, 11, 13, 14, 16, 17, 18, 19, 20, 21, 22, 24, 25, 28, 29, 30, 31, 32, 35, 37, 38, 47, 48, 51, 53, 54, 55, 59, 66, 67, 69, 72, 73, 78, 80, 82, 84, 85, 87, 89, 90, 91, 92, 93, 95, 96, 98, 99, 102, 103, 104, 106, 107, 108, 111, 118, 119, 120, 121, 123, 124, 125, 126, 127, 130, 132, 134, 136, 137, 138, 139, 141, 142, 145, 147, 151, 153, 155, 156, 163, 164, 165, 167, 169, 170, 171, 173, 177, 179, 180, 181, 182, 183, 184, 186, 188, 192, 193]"
JavaGuide,77688,375,349,26,"[1, 2, 4, 7, 8, 9, 12, 13, 14, 16, 18, 19, 21, 22, 25, 26, 28, 29, 32, 33, 35, 41, 43, 45, 46, 47, 48, 49, 50, 51, 52, 62, 64, 65, 68, 70, 71, 72, 75, 76, 82, 84, 85, 86, 87, 88, 91, 92, 97, 104, 105, 112, 120, 121, 122, 123, 124, 125, 126, 129, 130, 133, 137, 138, 139, 140, 141, 143, 144, 145, 146, 150, 152, 154, 161, 162, 163, 164, 165, 167, 168, 169, 170, 171, 172, 175, 178, 184, 189, 190, 194, 195, 196, 197, 200, 209, 211, 212, 214, 215]"
the-art-of-command-line,74932,163,79,84,"[2, 5, 6, 14, 15, 16, 19, 22, 23, 25, 26, 28, 32, 35, 36, 37, 54, 57, 61, 66, 67, 73, 75, 78, 79, 82, 87, 88, 95, 96, 99, 101, 103, 105, 108, 114, 115, 119, 121, 124, 126, 130, 146, 147, 149, 150, 151, 152, 153, 157, 158, 165, 166, 167, 179, 185, 211, 223, 224, 226, 231, 234, 236, 237, 244, 245, 258, 261, 262, 274, 280, 281, 284, 285, 291, 296, 305, 318, 320, 329, 330, 337, 342, 349, 351, 365, 371, 382, 399, 401, 412, 417, 419, 420, 421, 422, 423, 424, 425, 426]"
axios,72879,2271,2038,233,"[1, 2, 3, 4, 7, 8, 9, 11, 12, 14, 16, 17, 18, 19, 20, 23, 24, 26, 28, 29, 31, 33, 34, 36, 38, 39, 40, 41, 42, 43, 44, 45, 46, 47, 48, 50, 51, 53, 55, 56, 57, 58, 59, 60, 61, 62, 63, 64, 65, 66, 67, 68, 69, 70, 71, 72, 73, 75, 76, 77, 78, 79, 80, 81, 82, 83, 84, 86, 88, 89, 90, 92, 93, 94, 95, 97, 99, 103, 104, 107, 108, 110, 111, 113, 116, 117, 118, 119, 122, 124, 125, 129, 131, 134, 135, 137, 138, 141, 142, 143]"
go,72155,37610,31979,5631,"[1, 2, 3, 4, 5, 6, 7, 8, 9, 10, 11, 12, 13, 14, 15, 16, 17, 18, 19, 20, 21, 22, 23, 24, 25, 26, 27, 28, 29, 30, 31, 32, 33, 34, 35, 36, 37, 38, 39, 40, 41, 42, 43, 44, 45, 46, 47, 48, 49, 50, 51, 52, 53, 54, 55, 56, 57, 58, 59, 60, 61, 62, 63, 64, 65, 66, 67, 68, 69, 70, 71, 72, 73, 74, 75, 76, 77, 78, 79, 80, 81, 82, 83, 84, 85, 86, 87, 88, 89, 90, 91, 92, 93, 94, 95, 96, 97, 98, 99, 100]"
Python,70931,285,274,11,"[3, 11, 12, 13, 14, 43, 44, 47, 71, 76, 91, 93, 102, 105, 118, 119, 125, 126, 130, 131, 141, 145, 171, 187, 207, 219, 240, 245, 256, 258, 265, 288, 289, 291, 297, 299, 303, 309, 310, 315, 317, 320, 328, 329, 334, 336, 340, 353, 355, 361, 374, 378, 416, 432, 463, 472, 476, 478, 485, 492, 515, 529, 532, 539, 543, 550, 551, 590, 595, 596, 598, 604, 605, 609, 611, 614, 620, 622, 625, 626, 630, 663, 665, 668, 674, 684, 685, 687, 690, 697, 698, 700, 701, 703, 708, 710, 712, 716, 721, 727]"
build-your-own-x,70150,314,264,50,"[1, 2, 3, 5, 9, 11, 12, 13, 15, 17, 18, 20, 22, 24, 25, 26, 27, 29, 31, 33, 34, 40, 41, 43, 44, 49, 50, 52, 53, 56, 57, 60, 62, 65, 66, 67, 68, 69, 72, 74, 75, 78, 79, 81, 82, 83, 84, 85, 86, 87, 88, 89, 91, 94, 95, 96, 97, 98, 99, 100, 101, 102, 103, 104, 105, 106, 107, 108, 109, 110, 111, 112, 113, 114, 115, 117, 118, 119, 120, 122, 123, 124, 125, 126, 127, 128, 129, 130, 131, 132, 133, 134, 135, 136, 138, 139, 140, 141, 142, 143]"
node,69734,11559,10586,973,"[3, 4, 5, 7, 9, 11, 12, 13, 16, 18, 19, 20, 26, 27, 28, 30, 33, 37, 39, 40, 43, 46, 47, 50, 51, 52, 53, 54, 55, 59, 60, 61, 62, 63, 64, 65, 66, 67, 69, 70, 72, 73, 74, 77, 78, 79, 84, 86, 87, 88, 89, 90, 92, 93, 94, 95, 96, 99, 103, 104, 105, 106, 108, 110, 112, 117, 118, 119, 120, 121, 122, 123, 126, 128, 133, 134, 135, 136, 137, 139, 140, 146, 147, 149, 152, 153, 157, 158, 163, 164, 167, 168, 177, 179, 180, 183, 186, 188, 190, 192]"
javascript-algorithms,69528,134,83,51,"[1, 6, 7, 12, 13, 19, 21, 22, 24, 29, 30, 31, 34, 37, 38, 40, 41, 43, 44, 48, 49, 53, 54, 56, 57, 58, 63, 69, 70, 78, 87, 89, 90, 96, 98, 102, 103, 105, 107, 108, 111, 119, 122, 123, 129, 132, 143, 144, 145, 169, 179, 190, 191, 192, 195, 196, 197, 202, 206, 212, 213, 216, 217, 232, 234, 236, 248, 249, 251, 252, 253, 254, 264, 265, 271, 272, 274, 281, 287, 295, 297, 299, 302, 303, 305, 306, 307, 308, 310, 311, 312, 314, 315, 323, 325, 327, 328, 339, 344, 346]"
animate.css,66471,702,701,1,"[1, 2, 3, 4, 5, 6, 7, 10, 11, 12, 15, 16, 17, 18, 19, 20, 21, 22, 23, 24, 25, 26, 27, 30, 31, 32, 33, 35, 36, 37, 39, 41, 42, 43, 44, 45, 47, 48, 50, 53, 54, 55, 56, 57, 58, 59, 60, 61, 63, 64, 65, 66, 67, 69, 70, 71, 72, 73, 74, 75, 76, 77, 78, 79, 80, 82, 83, 84, 85, 86, 89, 90, 93, 96, 97, 99, 100, 101, 102, 105, 106, 109, 110, 111, 113, 114, 117, 118, 119, 121, 122, 126, 127, 129, 137, 138, 139, 142, 143, 144]"
free-programming-books-zh_CN,66134,0,0,0,[]
kubernetes,65773,34599,32578,2021,"[1, 2, 3, 4, 5, 6, 8, 9, 15, 19, 20, 32, 33, 34, 35, 50, 62, 64, 66, 67, 87, 96, 97, 103, 108, 109, 113, 114, 122, 124, 127, 128, 129, 132, 134, 137, 139, 140, 146, 147, 148, 153, 156, 157, 158, 159, 160, 168, 170, 172, 175, 186, 187, 188, 191, 193, 194, 195, 199, 204, 206, 207, 220, 222, 223, 234, 235, 236, 241, 245, 246, 248, 251, 260, 263, 267, 268, 270, 272, 274, 278, 281, 284, 285, 288, 291, 294, 295, 296, 297, 298, 299, 300, 301, 302, 304, 305, 317, 341, 347]"
youtube-dl,65733,20182,17397,2785,"[1, 2, 3, 4, 5, 6, 7, 8, 9, 10, 11, 12, 13, 14, 20, 21, 22, 25, 26, 28, 29, 34, 37, 38, 39, 40, 41, 42, 43, 44, 45, 46, 47, 48, 49, 54, 55, 56, 57, 58, 59, 60, 61, 66, 67, 69, 70, 72, 77, 78, 79, 80, 86, 87, 88, 89, 90, 91, 92, 93, 94, 95, 96, 97, 98, 99, 102, 103, 104, 105, 107, 108, 110, 111, 112, 115, 116, 118, 120, 122, 123, 125, 126, 127, 131, 133, 134, 135, 136, 137, 138, 139, 140, 142, 143, 144, 146, 147, 149, 151]"
models,63516,5275,4434,841,"[7, 8, 11, 13, 15, 16, 17, 18, 23, 25, 27, 32, 34, 37, 38, 46, 47, 48, 50, 52, 53, 54, 56, 59, 61, 65, 66, 67, 69, 70, 71, 72, 73, 74, 75, 77, 78, 79, 80, 81, 82, 84, 86, 87, 88, 90, 91, 93, 94, 95, 97, 98, 99, 100, 101, 102, 103, 104, 106, 107, 110, 111, 112, 114, 116, 118, 119, 120, 121, 122, 125, 126, 127, 128, 129, 130, 131, 132, 133, 134, 135, 136, 137, 139, 140, 141, 142, 143, 144, 145, 146, 148, 149, 153, 156, 157, 159, 160, 161, 162]"
Font-Awesome,62747,15912,10643,5269,"[1, 3, 4, 5, 6, 7, 8, 9, 10, 11, 12, 13, 14, 15, 16, 17, 18, 19, 20, 21, 22, 23, 24, 25, 26, 27, 28, 29, 30, 31, 32, 33, 34, 35, 36, 37, 38, 39, 40, 41, 43, 44, 45, 46, 47, 48, 49, 50, 51, 52, 54, 55, 56, 57, 58, 59, 60, 61, 63, 64, 65, 66, 67, 68, 69, 70, 71, 72, 73, 74, 75, 76, 77, 78, 79, 80, 81, 82, 85, 86, 87, 88, 89, 90, 91, 92, 93, 94, 95, 96, 97, 98, 99, 100, 101, 102, 103, 104, 105, 107]"
terminal,61083,4515,3654,861,"[2, 4, 5, 6, 7, 13, 15, 20, 22, 23, 24, 27, 28, 30, 31, 32, 34, 35, 36, 37, 38, 39, 40, 41, 42, 43, 44, 45, 46, 47, 48, 49, 51, 52, 53, 54, 55, 56, 57, 58, 59, 60, 61, 62, 63, 64, 65, 67, 68, 69, 70, 71, 72, 73, 74, 75, 76, 77, 78, 79, 80, 81, 82, 83, 84, 85, 86, 87, 88, 89, 90, 91, 92, 93, 94, 95, 96, 97, 98, 99, 100, 101, 102, 103, 104, 105, 106, 107, 108, 109, 110, 111, 112, 113, 114, 115, 116, 117, 118, 119]"
puppeteer,61019,3917,2943,974,"[1, 2, 3, 4, 5, 6, 7, 8, 9, 10, 11, 12, 13, 14, 15, 19, 20, 21, 26, 27, 30, 31, 33, 39, 40, 41, 42, 43, 44, 50, 51, 53, 54, 57, 60, 63, 65, 66, 68, 77, 78, 80, 84, 85, 86, 88, 89, 91, 100, 103, 104, 106, 107, 108, 109, 110, 111, 112, 113, 114, 115, 116, 117, 118, 119, 120, 121, 122, 127, 143, 146, 148, 149, 150, 156, 157, 158, 161, 166, 168, 178, 179, 180, 185, 198, 206, 213, 214, 217, 223, 226, 227, 228, 238, 241, 244, 246, 257, 258, 259]"
angular,60727,20689,17843,2846,"[1, 2, 3, 4, 5, 6, 7, 8, 9, 10, 11, 12, 13, 14, 15, 19, 20, 21, 22, 23, 24, 25, 26, 27, 28, 29, 30, 31, 32, 33, 34, 35, 37, 38, 39, 40, 41, 42, 43, 47, 48, 52, 53, 57, 58, 59, 61, 66, 67, 69, 70, 75, 80, 81, 82, 83, 84, 85, 86, 87, 88, 89, 90, 91, 92, 93, 94, 95, 99, 108, 112, 114, 115, 121, 122, 123, 124, 126, 128, 129, 130, 133, 135, 136, 138, 139, 140, 142, 143, 144, 145, 146, 147, 149, 150, 151, 153, 156, 157, 159]"
three.js,60317,9694,9247,447,"[1, 2, 3, 4, 5, 6, 7, 8, 9, 10, 11, 15, 16, 18, 21, 24, 25, 26, 30, 31, 32, 33, 34, 35, 36, 37, 40, 41, 42, 43, 44, 45, 46, 47, 48, 49, 50, 51, 52, 53, 54, 56, 57, 58, 59, 60, 61, 62, 63, 64, 65, 66, 67, 68, 69, 70, 72, 73, 74, 75, 76, 77, 78, 79, 80, 81, 83, 86, 88, 89, 90, 92, 93, 98, 99, 100, 101, 102, 103, 104, 105, 106, 107, 108, 109, 110, 111, 112, 113, 114, 115, 116, 117, 118, 119, 120, 122, 123, 124, 125]"
TypeScript,60050,26176,21786,4390,"[1, 5, 6, 7, 8, 9, 10, 11, 12, 13, 14, 15, 16, 17, 18, 19, 20, 21, 22, 24, 34, 39, 40, 41, 42, 43, 44, 45, 46, 47, 48, 49, 50, 51, 52, 53, 54, 55, 56, 57, 58, 59, 60, 61, 62, 63, 64, 65, 66, 67, 68, 69, 70, 71, 72, 73, 74, 75, 76, 77, 78, 79, 80, 81, 82, 83, 84, 85, 86, 87, 88, 89, 90, 91, 92, 93, 94, 95, 96, 97, 98, 99, 100, 101, 102, 103, 104, 105, 106, 107, 108, 109, 110, 111, 112, 113, 114, 115, 116, 117]"
angular.js,59543,8986,8596,390,"[1, 4, 10, 14, 19, 23, 26, 27, 28, 29, 30, 32, 33, 34, 35, 38, 39, 40, 45, 46, 48, 49, 51, 52, 53, 54, 55, 56, 57, 58, 59, 63, 65, 66, 73, 79, 80, 81, 85, 89, 90, 91, 92, 97, 98, 101, 103, 105, 106, 107, 112, 113, 114, 115, 119, 121, 122, 123, 126, 127, 128, 130, 131, 132, 134, 140, 141, 142, 143, 144, 145, 146, 148, 149, 150, 152, 153, 155, 156, 157, 159, 160, 162, 164, 165, 166, 167, 168, 169, 170, 171, 172, 174, 176, 177, 178, 180, 181, 182, 184]"
computer-science,59408,446,441,5,"[1, 2, 6, 12, 16, 28, 30, 31, 34, 35, 36, 38, 42, 43, 44, 45, 46, 48, 49, 50, 51, 52, 53, 55, 56, 58, 59, 63, 64, 65, 66, 68, 69, 71, 72, 73, 74, 75, 76, 77, 78, 79, 80, 81, 82, 83, 84, 85, 86, 87, 88, 89, 90, 91, 92, 93, 94, 95, 96, 98, 99, 100, 101, 102, 103, 104, 105, 106, 107, 109, 112, 113, 114, 115, 116, 117, 119, 120, 121, 122, 123, 124, 125, 126, 127, 128, 129, 130, 131, 132, 134, 136, 137, 139, 140, 141, 142, 143, 144, 145]"
ant-design,59391,17142,16694,448,"[1, 2, 3, 5, 7, 8, 9, 10, 11, 14, 15, 17, 18, 23, 24, 25, 27, 28, 31, 32, 33, 46, 48, 50, 51, 52, 58, 60, 61, 62, 64, 67, 68, 71, 72, 73, 78, 85, 94, 99, 103, 104, 112, 115, 118, 120, 127, 129, 130, 134, 136, 137, 138, 139, 142, 143, 144, 145, 146, 147, 150, 158, 159, 160, 161, 165, 166, 167, 168, 169, 170, 171, 172, 182, 185, 186, 190, 191, 192, 193, 194, 195, 196, 197, 198, 199, 203, 204, 205, 206, 207, 211, 212, 214, 215, 216, 217, 218, 219, 220]"
laravel,58969,0,0,0,[]
java-design-patterns,57480,541,379,162,"[4, 12, 13, 17, 25, 28, 34, 35, 38, 40, 43, 45, 50, 52, 53, 55, 56, 57, 59, 60, 61, 62, 63, 64, 65, 66, 67, 68, 69, 70, 71, 72, 73, 74, 75, 76, 77, 78, 79, 80, 81, 82, 83, 84, 85, 86, 87, 88, 89, 90, 91, 92, 93, 94, 95, 96, 97, 98, 99, 100, 101, 102, 103, 104, 105, 107, 108, 109, 110, 111, 112, 113, 114, 115, 116, 117, 118, 119, 120, 121, 122, 123, 124, 125, 126, 127, 128, 129, 130, 131, 132, 133, 134, 135, 136, 137, 138, 139, 140, 141]"
material-ui,57055,11023,10649,374,"[2, 3, 6, 8, 10, 13, 14, 16, 17, 18, 19, 20, 21, 22, 23, 24, 25, 26, 27, 28, 29, 30, 31, 32, 33, 34, 35, 36, 38, 39, 42, 43, 44, 45, 46, 47, 50, 51, 52, 55, 56, 57, 58, 61, 62, 63, 64, 65, 66, 67, 68, 70, 73, 78, 79, 80, 81, 82, 84, 85, 86, 87, 88, 89, 92, 93, 94, 95, 96, 97, 102, 103, 104, 105, 106, 107, 108, 109, 111, 112, 115, 118, 119, 123, 124, 125, 128, 129, 130, 132, 134, 136, 138, 141, 143, 145, 147, 148, 149, 150]"
moby,56987,20159,16560,3599,"[1, 2, 3, 4, 5, 6, 7, 8, 9, 10, 11, 13, 14, 18, 20, 21, 22, 24, 25, 26, 27, 28, 29, 30, 31, 32, 33, 34, 35, 36, 37, 38, 39, 40, 42, 44, 45, 46, 47, 50, 51, 52, 54, 55, 56, 60, 65, 67, 68, 69, 70, 71, 75, 77, 79, 80, 81, 82, 83, 85, 86, 87, 90, 91, 92, 93, 96, 97, 98, 103, 104, 107, 108, 109, 111, 113, 116, 117, 118, 120, 125, 129, 131, 132, 136, 137, 140, 141, 142, 144, 146, 148, 149, 150, 153, 156, 157, 158, 159, 162]"
30-seconds-of-code,56339,241,241,0,"[15, 16, 24, 41, 50, 57, 58, 62, 72, 74, 76, 78, 81, 94, 95, 100, 108, 111, 121, 133, 134, 139, 145, 146, 147, 156, 159, 160, 163, 168, 172, 173, 179, 182, 185, 188, 189, 191, 192, 195, 203, 206, 208, 214, 216, 217, 219, 223, 228, 233, 235, 236, 243, 247, 251, 252, 267, 269, 272, 275, 294, 295, 297, 299, 311, 324, 327, 333, 337, 346, 352, 355, 357, 374, 375, 376, 419, 426, 471, 473, 489, 517, 523, 525, 526, 530, 531, 538, 550, 560, 564, 566, 569, 580, 584, 587, 593, 601, 608, 612]"
awesome-go,54110,217,209,8,"[27, 31, 38, 51, 62, 66, 72, 73, 75, 100, 112, 115, 169, 208, 210, 231, 232, 237, 245, 266, 275, 282, 294, 298, 301, 305, 307, 315, 328, 335, 342, 363, 364, 372, 409, 422, 423, 439, 451, 465, 467, 485, 493, 497, 585, 595, 597, 605, 607, 608, 616, 649, 683, 718, 731, 747, 748, 768, 787, 798, 834, 839, 855, 891, 896, 902, 922, 945, 946, 949, 971, 983, 991, 1012, 1016, 1092, 1095, 1101, 1105, 1108, 1124, 1125, 1181, 1213, 1217, 1224, 1259, 1260, 1263, 1266, 1267, 1280, 1289, 1295, 1309, 1310, 1336, 1373, 1374, 1385]"
webpack,54086,7077,6721,356,"[3, 4, 5, 6, 7, 8, 9, 10, 11, 12, 13, 14, 15, 16, 17, 18, 19, 20, 21, 22, 23, 24, 25, 26, 27, 28, 29, 30, 31, 32, 34, 35, 37, 38, 39, 40, 41, 42, 43, 45, 46, 47, 48, 49, 50, 51, 53, 54, 55, 56, 57, 58, 59, 60, 61, 62, 63, 64, 65, 66, 67, 68, 69, 70, 71, 72, 73, 74, 75, 76, 77, 78, 79, 80, 81, 82, 83, 84, 85, 86, 87, 88, 89, 90, 91, 92, 93, 94, 95, 97, 98, 99, 100, 101, 103, 104, 105, 106, 108, 109]"
awesome-vue,53919,170,109,61,"[3, 74, 75, 85, 86, 121, 161, 163, 178, 180, 261, 293, 300, 320, 335, 387, 431, 439, 485, 545, 562, 563, 572, 598, 600, 615, 662, 676, 704, 756, 821, 836, 859, 879, 880, 936, 942, 976, 1002, 1049, 1092, 1093, 1098, 1115, 1156, 1165, 1182, 1184, 1224, 1244, 1288, 1322, 1325, 1381, 1389, 1393, 1407, 1411, 1462, 1477, 1489, 1553, 1608, 1614, 1647, 1656, 1657, 1672, 1674, 1691, 1700, 1719, 1721, 1745, 1768, 1769, 1779, 1853, 1862, 1869, 1884, 1940, 1949, 1962, 2008, 2013, 2021, 2059, 2060, 2061, 2068, 2070, 2076, 2135, 2144, 2149, 2151, 2156, 2177, 2180]"
vue-element-admin,53684,2682,2100,582,"[1, 2, 4, 5, 6, 7, 8, 9, 10, 11, 12, 14, 16, 17, 18, 19, 20, 21, 22, 23, 24, 25, 26, 28, 29, 30, 31, 35, 36, 37, 38, 39, 40, 44, 45, 46, 48, 49, 50, 53, 54, 55, 58, 60, 61, 62, 63, 64, 65, 66, 67, 68, 69, 70, 71, 72, 73, 74, 76, 77, 78, 79, 80, 82, 83, 84, 85, 86, 87, 89, 90, 91, 93, 94, 99, 100, 101, 103, 104, 105, 106, 107, 108, 110, 112, 113, 114, 115, 116, 118, 119, 120, 121, 122, 123, 124, 125, 126, 127, 129]"
LeetCodeAnimation,53402,32,32,0,"[1, 2, 4, 5, 6, 7, 12, 13, 14, 15, 17, 19, 20, 21, 22, 23, 27, 30, 32, 33, 35, 36, 38, 39, 40, 41, 42, 43, 44, 45, 46, 68]"
thefuck,53332,540,349,191,"[1, 2, 3, 4, 5, 6, 12, 13, 15, 16, 20, 21, 23, 24, 26, 28, 29, 32, 33, 34, 35, 37, 39, 47, 48, 50, 51, 58, 59, 66, 67, 68, 69, 71, 74, 80, 81, 83, 85, 87, 89, 90, 94, 97, 98, 100, 102, 103, 104, 105, 108, 111, 113, 115, 121, 124, 125, 126, 127, 128, 129, 131, 135, 136, 141, 142, 147, 151, 152, 153, 154, 155, 157, 161, 163, 168, 172, 173, 174, 175, 176, 178, 180, 181, 182, 184, 186, 189, 191, 194, 195, 207, 209, 210, 213, 217, 218, 220, 221, 222]"
jquery,53282,2005,1942,63,"[1669, 1670, 1671, 1673, 1674, 1677, 1679, 1681, 1684, 1686, 1687, 1689, 1690, 1691, 1692, 1693, 1694, 1695, 1696, 1698, 1700, 1701, 1702, 1703, 1705, 1706, 1707, 1708, 1709, 1710, 1711, 1712, 1713, 1717, 1718, 1721, 1722, 1723, 1724, 1725, 1726, 1727, 1728, 1729, 1730, 1731, 1732, 1733, 1734, 1735, 1736, 1737, 1738, 1739, 1740, 1741, 1742, 1743, 1744, 1745, 1746, 1747, 1748, 1749, 1750, 1751, 1752, 1753, 1754, 1755, 1756, 1757, 1758, 1759, 1760, 1761, 1762, 1763, 1764, 1765, 1766, 1767, 1768, 1769, 1770, 1771, 1772, 1773, 1774, 1775, 1776, 1777, 1778, 1779, 1780, 1781, 1782, 1783, 1784, 1785]"
redux,53106,1757,1728,29,"[1, 3, 4, 5, 6, 7, 8, 13, 14, 16, 17, 20, 22, 24, 35, 37, 38, 43, 45, 47, 48, 51, 57, 61, 68, 69, 70, 71, 76, 78, 83, 84, 88, 89, 90, 93, 97, 99, 100, 106, 108, 113, 115, 116, 117, 123, 124, 125, 128, 134, 135, 136, 137, 139, 143, 147, 148, 151, 152, 153, 154, 155, 156, 157, 158, 159, 160, 161, 162, 163, 164, 168, 170, 171, 173, 176, 177, 178, 180, 181, 183, 184, 186, 190, 191, 198, 199, 202, 203, 205, 206, 207, 208, 210, 211, 212, 215, 216, 218, 219]"
atom,51838,15654,15080,574,"[2, 5, 11, 13, 14, 25, 26, 27, 35, 39, 40, 41, 42, 43, 44, 45, 46, 47, 48, 49, 50, 53, 54, 58, 59, 63, 65, 66, 67, 68, 71, 72, 73, 74, 75, 76, 77, 78, 79, 80, 81, 82, 84, 85, 87, 95, 96, 101, 102, 103, 104, 105, 106, 118, 120, 121, 122, 125, 129, 130, 132, 134, 137, 139, 140, 143, 147, 148, 149, 150, 152, 153, 156, 159, 160, 161, 163, 164, 165, 166, 169, 173, 174, 175, 176, 180, 181, 182, 183, 184, 185, 186, 187, 188, 189, 190, 191, 192, 193, 194]"
swift,51485,0,0,0,[]
reveal.js,51446,1779,1311,468,"[2, 3, 4, 6, 7, 8, 9, 10, 11, 12, 14, 15, 16, 17, 18, 19, 22, 23, 24, 26, 28, 30, 31, 33, 38, 39, 40, 43, 44, 45, 46, 47, 49, 50, 51, 52, 54, 55, 59, 60, 62, 64, 66, 67, 70, 71, 73, 74, 76, 77, 78, 81, 82, 84, 86, 87, 88, 89, 90, 91, 92, 94, 95, 102, 104, 105, 111, 112, 113, 116, 118, 119, 122, 123, 124, 125, 127, 128, 129, 130, 133, 134, 137, 138, 139, 140, 143, 144, 145, 146, 147, 148, 149, 150, 152, 153, 154, 155, 157, 158]"
flask,50198,1926,1905,21,"[1, 2, 3, 4, 5, 6, 7, 8, 9, 10, 11, 12, 13, 14, 15, 16, 17, 18, 19, 20, 21, 22, 23, 24, 25, 26, 27, 28, 29, 30, 31, 32, 33, 34, 35, 36, 37, 38, 39, 40, 41, 42, 43, 44, 45, 46, 47, 48, 49, 50, 51, 52, 53, 54, 55, 56, 57, 58, 59, 60, 61, 62, 63, 64, 65, 66, 67, 68, 69, 70, 71, 72, 73, 74, 75, 76, 77, 78, 79, 80, 81, 82, 83, 84, 85, 86, 87, 88, 89, 90, 91, 92, 93, 94, 95, 96, 97, 98, 99, 100]"
socket.io,49495,2838,2362,476,"[1, 2, 3, 4, 5, 6, 7, 8, 9, 10, 11, 12, 13, 14, 15, 16, 17, 18, 19, 20, 21, 22, 23, 24, 25, 26, 27, 28, 29, 30, 31, 32, 33, 34, 35, 36, 37, 38, 39, 40, 41, 42, 43, 44, 45, 47, 48, 49, 50, 51, 54, 56, 57, 58, 59, 61, 62, 63, 65, 66, 68, 70, 71, 72, 73, 75, 78, 79, 81, 83, 84, 88, 89, 90, 91, 92, 96, 99, 100, 101, 103, 104, 106, 107, 109, 111, 114, 116, 117, 119, 122, 125, 126, 127, 128, 130, 133, 134, 135, 136]"
shadowsocks-windows,49181,2484,2439,45,"[1, 3, 4, 5, 7, 8, 9, 10, 11, 14, 15, 17, 18, 19, 20, 22, 24, 25, 26, 27, 28, 29, 30, 31, 32, 33, 38, 39, 42, 43, 47, 48, 50, 52, 53, 54, 55, 56, 57, 58, 60, 61, 63, 64, 65, 66, 67, 68, 69, 70, 71, 72, 73, 74, 77, 78, 79, 80, 81, 82, 83, 84, 85, 86, 87, 88, 89, 90, 91, 92, 93, 94, 95, 96, 97, 98, 99, 100, 101, 102, 103, 104, 105, 106, 108, 109, 110, 111, 112, 113, 114, 115, 116, 123, 124, 125, 126, 127, 128, 129]"
django,49059,0,0,0,[]
elasticsearch,48654,23619,21192,2427,"[1, 2, 3, 4, 5, 6, 7, 8, 9, 10, 11, 12, 13, 14, 15, 16, 17, 18, 19, 20, 21, 22, 23, 24, 25, 26, 27, 28, 29, 30, 31, 32, 33, 34, 35, 36, 37, 38, 39, 40, 41, 42, 43, 44, 45, 46, 47, 48, 49, 50, 51, 52, 53, 54, 55, 56, 57, 58, 59, 60, 61, 62, 63, 64, 65, 66, 67, 68, 69, 70, 71, 72, 73, 74, 75, 76, 77, 78, 79, 80, 81, 82, 83, 84, 85, 86, 87, 88, 89, 90, 91, 92, 93, 94, 95, 96, 97, 98, 99, 100]"
Chart.js,48582,5098,4708,390,"[1, 2, 3, 4, 5, 6, 7, 8, 9, 10, 11, 12, 13, 14, 15, 16, 17, 18, 20, 21, 23, 24, 25, 26, 28, 29, 30, 31, 32, 34, 36, 39, 40, 41, 42, 44, 45, 46, 47, 49, 50, 52, 54, 56, 58, 59, 60, 61, 63, 64, 65, 66, 67, 68, 70, 72, 73, 74, 76, 77, 78, 79, 80, 82, 83, 84, 86, 87, 88, 89, 90, 92, 93, 94, 95, 99, 100, 101, 102, 103, 104, 105, 106, 107, 108, 109, 110, 111, 113, 114, 115, 117, 118, 119, 121, 122, 123, 124, 127, 128]"
express,48488,3273,3179,94,"[1, 2, 3, 4, 5, 6, 7, 8, 9, 10, 11, 12, 13, 14, 15, 16, 17, 18, 19, 20, 21, 22, 23, 24, 25, 26, 27, 28, 29, 30, 31, 32, 33, 34, 35, 36, 37, 38, 39, 40, 41, 42, 43, 44, 45, 46, 47, 48, 49, 50, 51, 52, 53, 54, 55, 56, 57, 58, 59, 60, 61, 62, 63, 64, 65, 66, 67, 68, 69, 70, 71, 72, 73, 74, 75, 76, 77, 78, 79, 80, 81, 82, 83, 84, 85, 86, 87, 88, 89, 90, 91, 92, 93, 94, 95, 96, 97, 98, 99, 100]"
deno,48271,1865,1463,402,"[8, 9, 11, 12, 13, 14, 15, 17, 18, 19, 20, 21, 23, 25, 27, 30, 31, 34, 35, 37, 39, 41, 42, 43, 45, 47, 48, 49, 50, 51, 52, 53, 55, 56, 59, 60, 61, 62, 71, 74, 75, 76, 79, 81, 82, 86, 89, 91, 92, 94, 97, 103, 104, 106, 107, 109, 114, 117, 118, 119, 121, 123, 124, 125, 126, 128, 131, 132, 133, 145, 150, 152, 156, 157, 158, 159, 160, 162, 165, 166, 170, 171, 172, 175, 177, 178, 180, 184, 185, 186, 188, 189, 192, 195, 197, 199, 200, 202, 203, 205]"
keras,48081,10092,7133,2959,"[3, 4, 7, 8, 12, 14, 15, 16, 17, 18, 21, 26, 28, 30, 39, 40, 41, 44, 45, 46, 47, 50, 51, 52, 53, 54, 55, 56, 59, 60, 61, 68, 69, 70, 73, 75, 79, 80, 81, 85, 86, 87, 88, 89, 90, 91, 93, 94, 95, 96, 98, 100, 101, 102, 103, 104, 106, 107, 108, 109, 112, 113, 114, 115, 116, 117, 119, 120, 121, 126, 128, 129, 130, 131, 132, 133, 138, 139, 141, 142, 143, 146, 147, 148, 149, 150, 152, 156, 159, 160, 161, 162, 163, 165, 166, 167, 168, 169, 170, 174]"
Semantic-UI,47802,6091,5211,880,"[1, 2, 3, 4, 5, 6, 7, 8, 9, 10, 11, 12, 14, 15, 16, 17, 18, 20, 21, 22, 23, 24, 25, 26, 27, 28, 30, 31, 32, 33, 34, 35, 36, 37, 38, 39, 40, 41, 42, 43, 44, 45, 46, 47, 48, 49, 50, 51, 52, 53, 54, 56, 57, 58, 60, 61, 63, 64, 65, 66, 67, 68, 70, 71, 72, 73, 74, 75, 76, 77, 78, 79, 81, 82, 83, 84, 85, 86, 87, 88, 89, 90, 91, 92, 95, 97, 98, 100, 101, 102, 103, 104, 105, 106, 107, 108, 109, 112, 113, 114]"
next.js,47790,6300,5865,435,"[16, 17, 18, 19, 20, 21, 22, 23, 24, 25, 26, 28, 30, 33, 35, 36, 37, 40, 48, 50, 55, 56, 59, 62, 63, 64, 65, 67, 70, 71, 72, 75, 77, 78, 79, 80, 82, 83, 84, 85, 86, 87, 88, 89, 90, 91, 92, 94, 95, 96, 98, 99, 100, 102, 103, 104, 105, 106, 107, 109, 110, 112, 113, 114, 115, 116, 117, 118, 119, 120, 121, 122, 123, 126, 127, 130, 131, 132, 133, 137, 138, 139, 141, 143, 144, 145, 148, 149, 150, 151, 152, 153, 155, 159, 160, 161, 162, 166, 168, 170]"
storybook,47728,5270,4745,525,"[2, 3, 4, 5, 6, 7, 8, 9, 10, 11, 12, 13, 14, 15, 16, 19, 20, 21, 22, 23, 24, 25, 26, 29, 30, 32, 33, 34, 35, 36, 37, 38, 39, 40, 41, 42, 44, 45, 47, 48, 49, 50, 51, 53, 55, 56, 57, 58, 59, 61, 62, 65, 66, 72, 74, 75, 76, 79, 81, 82, 87, 89, 90, 92, 93, 95, 96, 99, 102, 105, 106, 108, 109, 110, 112, 113, 116, 117, 120, 121, 122, 124, 125, 127, 128, 129, 130, 131, 135, 136, 138, 139, 140, 142, 143, 145, 146, 150, 151, 155]"
spring-boot,47451,17037,16609,428,"[8, 14, 16, 19, 20, 21, 22, 26, 27, 30, 31, 34, 36, 39, 40, 42, 43, 44, 46, 47, 48, 54, 55, 56, 58, 62, 65, 66, 74, 78, 80, 81, 82, 83, 84, 86, 87, 88, 89, 90, 91, 92, 93, 94, 98, 99, 100, 101, 102, 104, 105, 106, 107, 108, 109, 110, 111, 112, 113, 114, 115, 116, 117, 119, 120, 121, 122, 125, 126, 128, 129, 130, 131, 133, 134, 135, 136, 137, 139, 140, 141, 142, 143, 144, 145, 146, 147, 148, 149, 150, 151, 153, 155, 156, 159, 161, 162, 163, 164, 167]"
json-server,47151,863,394,469,"[3, 5, 9, 10, 11, 12, 13, 16, 17, 18, 21, 24, 25, 28, 30, 31, 33, 34, 35, 37, 39, 40, 41, 42, 43, 44, 45, 46, 47, 48, 49, 54, 56, 57, 58, 59, 60, 61, 62, 63, 64, 65, 67, 69, 70, 72, 74, 75, 76, 78, 80, 83, 85, 86, 87, 89, 90, 91, 93, 94, 96, 97, 98, 99, 102, 103, 105, 107, 108, 110, 111, 112, 113, 114, 115, 116, 118, 123, 124, 125, 126, 128, 131, 132, 135, 136, 137, 139, 141, 142, 143, 144, 145, 146, 147, 149, 150, 151, 152, 153]"
Apollo-11,47042,359,264,95,"[3, 5, 8, 9, 12, 14, 15, 16, 17, 19, 20, 21, 22, 23, 24, 25, 26, 28, 29, 31, 33, 34, 35, 36, 37, 38, 39, 40, 41, 42, 44, 45, 46, 47, 48, 50, 52, 53, 55, 56, 59, 61, 62, 63, 64, 65, 67, 69, 70, 71, 74, 81, 82, 94, 96, 97, 98, 99, 100, 101, 102, 103, 104, 107, 108, 109, 110, 112, 113, 114, 115, 116, 117, 118, 124, 126, 127, 128, 135, 136, 138, 139, 140, 142, 145, 147, 153, 158, 159, 165, 171, 173, 190, 191, 192, 193, 194, 195, 196, 197]"
FiraCode,46744,890,651,239,"[1, 2, 3, 4, 5, 6, 7, 8, 11, 12, 13, 15, 16, 17, 18, 19, 20, 21, 22, 23, 25, 26, 27, 28, 29, 30, 32, 33, 34, 35, 36, 38, 39, 40, 41, 42, 43, 44, 45, 46, 48, 49, 50, 53, 55, 59, 61, 62, 63, 64, 65, 66, 67, 69, 70, 71, 73, 75, 76, 77, 79, 82, 83, 85, 86, 87, 88, 89, 90, 91, 92, 95, 96, 98, 99, 100, 101, 102, 104, 105, 106, 107, 110, 112, 113, 114, 115, 116, 117, 118, 119, 120, 121, 122, 123, 124, 125, 127, 128, 131]"
httpie,46628,599,462,137,"[1, 4, 7, 8, 11, 22, 23, 26, 27, 29, 30, 31, 32, 36, 37, 39, 41, 42, 46, 48, 49, 53, 54, 57, 58, 59, 60, 61, 62, 63, 66, 71, 73, 76, 77, 78, 79, 80, 81, 82, 83, 84, 85, 86, 87, 88, 89, 91, 92, 93, 94, 95, 96, 97, 98, 99, 100, 101, 102, 103, 104, 105, 106, 107, 109, 110, 111, 112, 113, 115, 116, 117, 118, 119, 120, 121, 122, 124, 125, 126, 128, 129, 130, 131, 132, 133, 134, 136, 137, 138, 139, 140, 141, 143, 144, 145, 146, 147, 148, 149]"
netdata,46504,5170,4471,699,"[1, 10, 11, 12, 13, 14, 15, 16, 22, 24, 25, 26, 28, 30, 34, 36, 37, 38, 39, 40, 41, 42, 43, 44, 46, 48, 49, 50, 51, 52, 53, 54, 55, 56, 57, 58, 59, 60, 62, 63, 64, 65, 66, 67, 68, 69, 70, 71, 74, 75, 76, 78, 79, 80, 81, 82, 83, 84, 85, 86, 87, 88, 89, 91, 92, 93, 94, 95, 97, 98, 100, 101, 102, 103, 104, 105, 106, 107, 108, 109, 110, 112, 114, 115, 116, 117, 118, 119, 120, 121, 122, 123, 124, 125, 126, 127, 128, 129, 130, 131]"
markdown-here,46117,542,290,252,"[1, 2, 3, 4, 5, 6, 7, 8, 9, 10, 11, 12, 13, 14, 15, 16, 17, 18, 19, 20, 21, 22, 23, 24, 25, 26, 27, 28, 29, 30, 31, 32, 33, 34, 35, 36, 37, 38, 39, 40, 41, 42, 43, 44, 45, 46, 47, 48, 49, 50, 51, 52, 53, 54, 55, 56, 57, 58, 59, 60, 61, 62, 63, 64, 65, 66, 67, 68, 69, 70, 71, 72, 73, 74, 75, 76, 77, 78, 79, 80, 81, 82, 83, 84, 85, 86, 87, 88, 89, 90, 91, 92, 93, 94, 95, 96, 97, 98, 100, 101]"
rails,45534,13704,13304,400,"[1, 2, 3, 326, 329, 330, 335, 337, 341, 342, 348, 361, 363, 364, 371, 372, 379, 385, 386, 393, 398, 401, 402, 403, 404, 405, 406, 407, 409, 411, 412, 415, 416, 417, 421, 422, 426, 428, 429, 436, 437, 439, 440, 441, 443, 444, 447, 450, 453, 462, 466, 470, 472, 473, 474, 475, 476, 477, 478, 479, 480, 481, 483, 485, 486, 488, 489, 497, 502, 508, 510, 511, 517, 518, 520, 522, 525, 526, 529, 533, 534, 535, 539, 543, 544, 545, 546, 548, 552, 555, 557, 558, 559, 562, 565, 566, 567, 569, 571, 574]"
architect-awesome,45184,62,18,44,"[4, 5, 6, 7, 10, 11, 12, 14, 17, 18, 20, 25, 32, 34, 35, 36, 37, 38, 39, 40, 43, 45, 49, 50, 52, 54, 55, 57, 58, 60, 61, 63, 74, 75, 78, 80, 81, 82, 83, 84, 85, 86, 89, 91, 94, 98, 100, 105, 106, 107, 108, 113, 114, 115, 116, 118, 119, 121, 122, 123, 124, 126]"
element,45092,14995,13524,1471,"[1, 3, 4, 5, 8, 9, 12, 15, 16, 17, 22, 25, 30, 35, 40, 56, 58, 60, 64, 66, 67, 71, 73, 74, 75, 76, 78, 80, 81, 84, 91, 92, 97, 99, 103, 120, 121, 122, 123, 126, 128, 129, 131, 133, 134, 137, 138, 139, 141, 143, 146, 148, 150, 151, 152, 156, 157, 159, 160, 162, 163, 165, 166, 169, 170, 171, 175, 176, 179, 180, 181, 185, 186, 187, 189, 190, 194, 195, 197, 198, 199, 200, 202, 203, 204, 205, 207, 208, 209, 210, 211, 212, 214, 219, 220, 221, 222, 223, 224, 228]"
html5-boilerplate,44762,1166,1161,5,"[1, 2, 3, 4, 5, 6, 7, 8, 9, 10, 11, 12, 13, 14, 15, 16, 17, 18, 19, 20, 21, 22, 23, 24, 25, 26, 27, 28, 29, 30, 31, 32, 33, 34, 35, 36, 37, 38, 39, 40, 41, 42, 43, 44, 45, 46, 47, 48, 49, 50, 51, 52, 53, 54, 55, 56, 57, 58, 59, 60, 61, 62, 63, 64, 65, 66, 67, 68, 69, 70, 71, 72, 73, 74, 75, 76, 77, 78, 79, 80, 81, 82, 88, 89, 90, 91, 93, 94, 95, 97, 99, 100, 101, 102, 103, 105, 108, 109, 110, 111]"
lodash,44630,3651,3591,60,"[6, 8, 10, 11, 12, 13, 14, 15, 16, 19, 20, 21, 22, 24, 25, 26, 27, 28, 29, 30, 31, 33, 34, 36, 40, 42, 43, 44, 45, 46, 47, 48, 49, 51, 52, 53, 54, 55, 56, 57, 59, 60, 61, 62, 63, 64, 66, 67, 68, 69, 71, 72, 73, 74, 75, 76, 77, 78, 79, 80, 81, 82, 84, 85, 86, 88, 89, 91, 92, 94, 95, 97, 98, 99, 100, 101, 103, 105, 106, 109, 110, 111, 112, 113, 114, 115, 116, 117, 120, 121, 122, 123, 124, 125, 126, 127, 130, 131, 133, 134]"
rust,44528,34094,28680,5414,"[1, 2, 3, 4, 5, 6, 7, 8, 9, 10, 11, 12, 13, 14, 15, 16, 17, 18, 19, 20, 21, 22, 23, 24, 25, 26, 27, 28, 29, 30, 31, 32, 33, 34, 35, 36, 37, 38, 39, 40, 41, 42, 43, 44, 45, 46, 47, 48, 49, 50, 51, 52, 53, 54, 55, 56, 57, 58, 59, 60, 61, 62, 63, 64, 65, 66, 67, 68, 69, 70, 71, 72, 73, 74, 75, 76, 77, 78, 79, 80, 81, 82, 83, 84, 85, 86, 87, 88, 89, 90, 91, 92, 93, 94, 95, 96, 97, 98, 99, 100]"
awesome-machine-learning,44521,63,63,0,"[26, 34, 41, 46, 47, 49, 93, 105, 121, 128, 130, 140, 147, 148, 170, 185, 188, 190, 206, 213, 216, 231, 245, 247, 286, 305, 311, 322, 323, 330, 336, 342, 343, 365, 380, 385, 386, 395, 398, 427, 435, 467, 482, 485, 486, 489, 493, 495, 496, 498, 505, 509, 534, 546, 551, 564, 577, 605, 614, 620, 644, 682, 687]"
Front-end-Developer-Interview-Questions,44323,97,93,4,"[5, 7, 11, 14, 21, 23, 26, 30, 35, 41, 58, 87, 96, 109, 110, 113, 114, 121, 128, 158, 159, 160, 161, 162, 178, 186, 208, 217, 221, 223, 227, 229, 230, 231, 234, 235, 242, 247, 249, 257, 258, 263, 266, 269, 272, 273, 274, 277, 279, 280, 281, 300, 302, 304, 307, 312, 319, 331, 335, 338, 345, 350, 357, 361, 363, 367, 369, 370, 373, 382, 383, 396, 409, 421, 433, 435, 443, 444, 446, 448, 449, 450, 455, 459, 463, 471, 472, 477, 480, 487, 509, 511, 517, 518, 522, 531, 534]"
resume.github.com,44289,83,54,29,"[2, 3, 4, 5, 6, 7, 9, 10, 11, 12, 13, 15, 16, 17, 30, 31, 32, 34, 35, 39, 40, 42, 44, 48, 51, 55, 57, 61, 64, 69, 70, 72, 73, 127, 147, 148, 151, 152, 155, 157, 158, 159, 160, 161, 166, 168, 173, 175, 177, 179, 182, 187, 189, 191, 193, 194, 195, 196, 197, 201, 203, 206, 208, 210, 216, 217, 222, 226, 234, 235, 236, 238, 239, 240, 242, 243, 244, 245, 246, 247, 251, 253, 258]"
opencv,44257,6551,4842,1709,"[4227, 4230, 4235, 4236, 4237, 4240, 4241, 4242, 4243, 4244, 4245, 4246, 4247, 4248, 4249, 4250, 4251, 4252, 4253, 4254, 4255, 4256, 4257, 4258, 4259, 4260, 4261, 4262, 4263, 4264, 4265, 4266, 4267, 4268, 4269, 4270, 4271, 4272, 4273, 4274, 4275, 4276, 4277, 4278, 4279, 4280, 4281, 4282, 4283, 4284, 4285, 4286, 4287, 4288, 4289, 4290, 4291, 4292, 4293, 4294, 4295, 4296, 4297, 4298, 4299, 4300, 4301, 4302, 4303, 4304, 4305, 4306, 4307, 4308, 4309, 4310, 4311, 4312, 4313, 4314, 4315, 4316, 4317, 4318, 4319, 4320, 4321, 4322, 4323, 4324, 4325, 4326, 4327, 4328, 4329, 4330, 4331, 4332, 4333, 4334]"
awesome-selfhosted,44204,511,450,61,"[8, 13, 14, 20, 23, 30, 31, 35, 37, 42, 55, 56, 57, 60, 63, 65, 72, 88, 89, 99, 100, 104, 114, 118, 121, 122, 123, 127, 128, 138, 139, 140, 141, 145, 146, 147, 148, 149, 150, 152, 159, 161, 162, 167, 169, 172, 173, 178, 183, 192, 195, 196, 197, 205, 211, 214, 215, 216, 217, 224, 225, 230, 233, 234, 238, 239, 240, 241, 242, 243, 244, 245, 246, 247, 248, 249, 250, 251, 252, 253, 254, 256, 257, 258, 259, 260, 261, 262, 263, 264, 265, 266, 267, 269, 270, 275, 276, 277, 278, 279]"
gatsby,44094,10308,9666,642,"[1, 2, 3, 4, 5, 6, 7, 8, 9, 10, 11, 12, 13, 14, 15, 16, 17, 18, 19, 20, 21, 22, 24, 25, 27, 29, 30, 32, 33, 39, 41, 42, 43, 46, 47, 50, 52, 54, 56, 57, 58, 63, 64, 66, 74, 80, 83, 86, 88, 89, 90, 93, 94, 97, 98, 100, 101, 105, 106, 107, 108, 112, 114, 117, 118, 119, 122, 123, 124, 125, 126, 127, 128, 129, 130, 131, 132, 133, 134, 135, 136, 138, 139, 141, 142, 143, 144, 145, 147, 148, 149, 150, 151, 152, 153, 154, 155, 156, 157, 158]"
moment,43933,3654,3279,375,"[1, 2, 3, 4, 6, 7, 8, 10, 11, 13, 14, 17, 18, 19, 20, 21, 22, 23, 24, 26, 27, 29, 34, 35, 40, 42, 45, 46, 48, 49, 55, 56, 58, 61, 63, 64, 67, 68, 69, 71, 72, 73, 75, 76, 78, 79, 80, 82, 83, 85, 87, 88, 89, 90, 91, 92, 94, 95, 96, 101, 102, 103, 104, 105, 106, 107, 108, 109, 110, 111, 113, 114, 115, 116, 117, 118, 121, 122, 123, 125, 126, 128, 133, 134, 137, 138, 139, 140, 141, 142, 143, 144, 146, 147, 148, 150, 151, 152, 153, 154]"
hugo,43748,4596,4119,477,"[4, 5, 7, 9, 13, 14, 16, 17, 18, 23, 27, 28, 30, 33, 45, 47, 48, 57, 58, 59, 60, 61, 62, 63, 65, 68, 69, 70, 71, 74, 75, 76, 77, 79, 80, 81, 82, 85, 86, 87, 88, 89, 90, 91, 92, 93, 94, 95, 96, 97, 98, 99, 100, 101, 102, 103, 104, 105, 106, 107, 108, 109, 110, 111, 112, 114, 116, 117, 119, 120, 122, 126, 129, 130, 137, 140, 141, 143, 144, 145, 147, 148, 149, 150, 151, 152, 153, 154, 156, 157, 158, 160, 162, 163, 164, 166, 167, 168, 170, 171]"
interviews,43738,43,16,27,"[3, 5, 10, 11, 12, 15, 26, 35, 44, 45, 46, 52, 56, 59, 61, 63, 66, 85, 91, 94, 99, 100, 101, 106, 107, 108, 109, 112, 114, 118, 122, 123, 124, 125, 127, 129, 144, 152, 154, 155, 156, 157, 158]"
nodebestpractices,43481,178,159,19,"[4, 11, 13, 15, 17, 22, 25, 26, 31, 33, 36, 43, 46, 47, 50, 51, 53, 54, 55, 63, 67, 69, 71, 72, 73, 74, 77, 78, 80, 84, 87, 90, 91, 92, 94, 95, 98, 105, 129, 130, 133, 135, 139, 141, 143, 146, 154, 155, 156, 160, 167, 169, 172, 173, 183, 186, 187, 192, 193, 196, 197, 198, 202, 203, 204, 205, 209, 211, 212, 220, 221, 222, 223, 224, 225, 227, 231, 233, 239, 240, 245, 247, 248, 249, 252, 253, 254, 256, 257, 258, 265, 267, 268, 271, 276, 277, 286, 290, 291, 292]"
bitcoin,43201,5402,4834,568,"[1, 2, 3, 4, 5, 6, 7, 8, 12, 13, 14, 15, 16, 17, 18, 20, 22, 25, 26, 28, 29, 31, 34, 39, 44, 45, 47, 48, 49, 50, 58, 60, 61, 64, 65, 66, 67, 68, 69, 70, 71, 73, 75, 76, 77, 78, 80, 84, 86, 87, 89, 93, 94, 99, 100, 102, 103, 108, 119, 128, 129, 130, 135, 140, 144, 145, 146, 147, 148, 156, 158, 166, 167, 170, 171, 172, 175, 185, 188, 189, 191, 200, 206, 207, 210, 211, 212, 216, 217, 219, 227, 228, 231, 233, 236, 237, 238, 239, 240, 241]"
advanced-java,43092,94,84,10,"[1, 2, 3, 4, 5, 6, 9, 10, 12, 14, 17, 18, 20, 22, 28, 32, 33, 34, 35, 37, 38, 39, 40, 41, 42, 43, 44, 45, 46, 47, 50, 51, 54, 55, 56, 58, 60, 61, 62, 63, 64, 66, 67, 68, 70, 71, 72, 73, 74, 75, 76, 79, 80, 81, 82, 86, 89, 90, 91, 92, 99, 100, 101, 102, 107, 109, 110, 111, 115, 117, 119, 125, 126, 127, 128, 130, 133, 134, 135, 136, 137, 138, 139, 140, 141, 147, 148, 149, 150, 151, 155, 156, 157, 159]"
ansible,42997,27055,22874,4181,"[1, 2, 4, 5, 6, 7, 8, 9, 10, 11, 12, 13, 14, 15, 17, 18, 19, 20, 21, 22, 23, 24, 26, 27, 29, 30, 31, 32, 33, 34, 35, 36, 37, 38, 39, 40, 41, 42, 43, 44, 45, 46, 47, 48, 49, 50, 51, 52, 53, 54, 55, 56, 57, 58, 59, 60, 61, 62, 63, 64, 65, 66, 67, 68, 69, 71, 72, 74, 76, 77, 80, 81, 82, 83, 84, 85, 86, 87, 89, 93, 95, 99, 107, 111, 112, 117, 118, 119, 122, 124, 125, 127, 128, 130, 133, 135, 137, 138, 139, 140]"
redis,42635,4165,2373,1792,"[1, 2, 3, 4, 5, 6, 7, 8, 9, 10, 11, 12, 80, 81, 82, 83, 84, 85, 86, 87, 88, 89, 90, 91, 92, 93, 94, 95, 96, 98, 100, 101, 102, 103, 104, 105, 106, 107, 108, 109, 110, 111, 112, 113, 115, 116, 117, 119, 120, 121, 122, 123, 124, 125, 128, 129, 130, 131, 132, 133, 134, 135, 136, 139, 140, 141, 142, 143, 144, 145, 148, 150, 151, 152, 153, 155, 156, 157, 158, 159, 160, 161, 162, 163, 164, 165, 166, 167, 168, 169, 172, 174, 175, 176, 177, 178, 179, 180, 182, 183]"
RxJava,42567,2908,2898,10,"[7, 8, 9, 10, 11, 12, 13, 14, 15, 16, 17, 18, 19, 20, 21, 22, 23, 24, 25, 26, 28, 29, 30, 31, 32, 33, 34, 35, 36, 37, 38, 39, 40, 41, 42, 43, 44, 45, 46, 47, 48, 49, 50, 51, 52, 53, 54, 55, 56, 57, 58, 59, 60, 61, 62, 63, 64, 65, 66, 67, 68, 69, 70, 71, 72, 73, 74, 75, 76, 77, 78, 79, 80, 81, 82, 83, 84, 85, 86, 87, 88, 89, 90, 91, 92, 93, 94, 95, 96, 97, 98, 99, 100, 101, 102, 103, 104, 118, 119, 123]"
requests,42393,3127,2904,223,"[1, 2, 3, 5, 6, 7, 9, 11, 12, 13, 16, 18, 19, 20, 21, 22, 23, 27, 30, 31, 33, 36, 40, 41, 44, 47, 48, 49, 50, 51, 52, 53, 54, 55, 56, 57, 60, 61, 63, 64, 65, 68, 69, 70, 71, 72, 73, 74, 75, 76, 78, 79, 80, 83, 84, 85, 86, 88, 90, 91, 92, 94, 95, 97, 98, 101, 102, 103, 105, 109, 110, 112, 114, 115, 116, 120, 126, 127, 128, 133, 134, 135, 138, 140, 141, 143, 145, 147, 148, 151, 152, 153, 154, 155, 156, 157, 159, 160, 161, 162]"
tech-interview-handbook,42354,0,0,0,[]
meteor,41751,8315,8214,101,"[3, 10, 11, 12, 13, 14, 15, 16, 17, 18, 29, 30, 31, 32, 34, 38, 42, 44, 46, 57, 59, 61, 65, 73, 74, 75, 81, 87, 89, 90, 95, 100, 102, 103, 104, 105, 106, 107, 108, 109, 110, 111, 113, 114, 115, 125, 126, 127, 128, 130, 131, 132, 133, 134, 137, 139, 142, 143, 144, 147, 148, 149, 151, 153, 154, 155, 157, 159, 160, 163, 167, 168, 169, 170, 171, 176, 177, 180, 181, 182, 183, 184, 185, 186, 189, 190, 191, 192, 194, 195, 196, 197, 198, 200, 203, 206, 207, 208, 209, 211]"
nvm,41568,1377,1138,239,"[1, 2, 3, 4, 5, 6, 7, 8, 9, 11, 12, 13, 14, 19, 20, 21, 22, 23, 25, 27, 28, 29, 30, 31, 32, 35, 36, 37, 38, 39, 41, 43, 45, 46, 48, 50, 53, 55, 56, 58, 59, 61, 64, 66, 68, 69, 72, 73, 75, 77, 78, 79, 84, 85, 86, 87, 89, 90, 91, 92, 94, 98, 99, 101, 110, 112, 113, 114, 116, 117, 119, 121, 122, 123, 124, 126, 127, 128, 135, 137, 138, 139, 140, 141, 142, 143, 147, 151, 153, 159, 162, 167, 168, 172, 174, 179, 180, 185, 186, 190]"
every-programmer-should-know,41500,28,16,12,"[1, 12, 18, 19, 20, 21, 22, 24, 25, 26, 39, 42, 46, 56, 57, 59, 60, 90, 93, 111, 123, 126, 129, 138, 141, 142, 149, 151]"
protobuf,41345,3882,2981,901,"[2, 6, 7, 9, 10, 11, 13, 14, 16, 17, 19, 22, 23, 24, 25, 26, 33, 34, 36, 40, 41, 42, 44, 45, 47, 49, 51, 52, 53, 54, 55, 56, 58, 59, 60, 61, 62, 63, 64, 65, 67, 68, 74, 75, 77, 78, 80, 83, 85, 87, 90, 92, 93, 94, 95, 96, 97, 98, 99, 107, 108, 112, 117, 119, 120, 122, 124, 125, 129, 132, 133, 137, 138, 140, 141, 142, 144, 147, 148, 149, 152, 156, 157, 159, 167, 169, 170, 173, 176, 177, 179, 181, 182, 184, 188, 192, 194, 198, 200, 202]"
nocode,41273,3519,417,3102,"[1, 2, 3, 4, 5, 6, 7, 8, 9, 10, 11, 12, 13, 14, 16, 17, 18, 20, 22, 23, 27, 29, 30, 32, 33, 34, 36, 37, 39, 40, 41, 43, 44, 46, 47, 49, 50, 51, 52, 53, 55, 56, 57, 58, 60, 61, 62, 63, 64, 65, 67, 68, 70, 72, 73, 74, 77, 78, 79, 80, 81, 82, 83, 84, 86, 87, 88, 89, 90, 92, 93, 94, 96, 97, 98, 100, 102, 103, 104, 106, 107, 109, 110, 111, 112, 113, 114, 115, 116, 117, 118, 120, 121, 122, 123, 124, 125, 127, 128, 129]"
ionic,40893,17382,16608,774,"[1, 2, 3, 4, 5, 6, 7, 8, 9, 10, 11, 12, 13, 14, 15, 16, 17, 18, 19, 20, 21, 22, 23, 24, 25, 26, 27, 28, 29, 30, 31, 32, 33, 34, 35, 36, 37, 38, 39, 40, 41, 42, 43, 44, 45, 46, 47, 48, 49, 50, 51, 52, 53, 54, 55, 56, 57, 58, 59, 60, 61, 62, 63, 64, 65, 66, 67, 68, 69, 70, 71, 72, 73, 74, 75, 76, 77, 78, 79, 80, 81, 82, 83, 84, 85, 86, 87, 88, 89, 90, 91, 92, 93, 94, 95, 96, 97, 98, 99, 100]"
incubator-echarts,40840,11855,10094,1761,"[5, 8, 9, 10, 11, 14, 15, 16, 18, 21, 22, 23, 25, 26, 30, 31, 32, 33, 35, 36, 38, 39, 41, 42, 45, 46, 47, 48, 50, 52, 53, 54, 55, 56, 58, 59, 60, 62, 64, 65, 68, 69, 70, 71, 72, 73, 74, 75, 76, 77, 78, 79, 80, 81, 82, 83, 84, 85, 86, 88, 89, 90, 92, 93, 95, 96, 97, 98, 99, 100, 101, 102, 104, 107, 109, 110, 111, 112, 113, 114, 115, 116, 118, 119, 120, 121, 122, 123, 124, 125, 126, 128, 129, 130, 131, 132, 133, 134, 135, 136]"
scikit-learn,40543,7406,5885,1521,"[1, 5, 7, 8, 11, 12, 13, 18, 20, 21, 32, 35, 36, 37, 38, 41, 44, 45, 46, 50, 51, 56, 58, 60, 61, 62, 63, 64, 65, 66, 73, 75, 76, 77, 78, 79, 80, 81, 82, 83, 87, 88, 91, 95, 96, 98, 100, 101, 104, 108, 110, 111, 115, 126, 139, 142, 145, 146, 156, 158, 159, 165, 166, 169, 170, 171, 172, 173, 174, 175, 177, 179, 183, 187, 189, 190, 191, 192, 195, 202, 204, 208, 213, 214, 215, 217, 220, 225, 229, 231, 232, 237, 238, 239, 240, 245, 250, 252, 253, 256]"
react-router,40349,5407,5373,34,"[2, 3, 4, 5, 6, 7, 8, 9, 13, 15, 16, 17, 18, 20, 21, 22, 24, 26, 27, 28, 30, 31, 33, 34, 35, 38, 39, 42, 43, 45, 46, 47, 49, 50, 56, 57, 58, 59, 60, 61, 62, 65, 66, 70, 72, 73, 74, 75, 76, 77, 78, 80, 82, 83, 84, 85, 86, 87, 88, 89, 96, 97, 98, 99, 101, 102, 103, 105, 107, 108, 110, 111, 112, 113, 115, 116, 117, 119, 121, 123, 128, 130, 131, 132, 133, 135, 136, 138, 139, 140, 141, 142, 143, 144, 146, 147, 149, 150, 151, 153]"
jekyll,40303,4175,4082,93,"[1, 2, 3, 4, 5, 6, 7, 8, 9, 10, 11, 12, 13, 14, 15, 16, 17, 18, 19, 20, 21, 22, 23, 24, 25, 26, 27, 28, 29, 30, 31, 32, 33, 34, 35, 36, 37, 38, 39, 40, 41, 42, 43, 44, 45, 46, 47, 48, 49, 50, 51, 52, 53, 54, 55, 56, 57, 58, 59, 60, 61, 62, 63, 64, 65, 66, 67, 68, 69, 70, 71, 72, 73, 74, 75, 76, 77, 78, 79, 80, 81, 82, 83, 84, 85, 86, 87, 88, 89, 90, 91, 92, 93, 94, 95, 96, 97, 98, 99, 100]"
papers-we-love,40205,128,116,12,"[1, 3, 9, 19, 20, 23, 25, 26, 27, 28, 29, 30, 38, 41, 42, 44, 47, 50, 51, 52, 55, 59, 62, 68, 69, 71, 88, 89, 91, 96, 98, 101, 102, 110, 115, 116, 118, 123, 128, 130, 132, 137, 140, 146, 147, 158, 166, 167, 169, 171, 175, 176, 183, 187, 193, 197, 198, 199, 204, 211, 214, 245, 252, 254, 257, 258, 259, 260, 274, 275, 286, 290, 291, 301, 309, 310, 311, 318, 319, 323, 332, 333, 336, 346, 348, 349, 351, 359, 360, 374, 375, 382, 386, 402, 418, 443, 444, 453, 454, 461]"
realworld,40187,335,141,194,"[1, 2, 3, 4, 6, 7, 9, 10, 11, 12, 13, 15, 16, 17, 18, 19, 20, 21, 22, 23, 24, 26, 27, 28, 29, 30, 31, 33, 35, 36, 37, 38, 39, 40, 41, 42, 43, 44, 45, 46, 47, 48, 49, 50, 51, 52, 53, 54, 55, 56, 57, 58, 59, 60, 61, 62, 63, 64, 65, 66, 67, 69, 70, 71, 72, 73, 74, 76, 77, 78, 79, 80, 81, 82, 83, 84, 85, 86, 87, 88, 89, 90, 91, 93, 95, 96, 98, 99, 101, 102, 103, 105, 107, 108, 110, 111, 112, 113, 115, 116]"
material-design-icons,40131,862,306,556,"[1, 2, 3, 5, 6, 7, 8, 9, 11, 12, 13, 14, 15, 16, 17, 18, 19, 21, 22, 23, 26, 27, 28, 29, 30, 31, 32, 33, 35, 36, 37, 38, 39, 40, 41, 42, 43, 44, 46, 47, 48, 49, 51, 52, 53, 54, 55, 56, 57, 58, 59, 60, 61, 62, 63, 64, 65, 66, 67, 68, 69, 70, 71, 72, 73, 74, 75, 76, 77, 78, 79, 80, 81, 83, 84, 85, 86, 87, 88, 89, 90, 91, 92, 93, 94, 95, 96, 97, 98, 99, 101, 102, 103, 104, 105, 106, 107, 108, 109, 110]"
bulma,39632,2004,1801,203,"[1, 2, 5, 6, 7, 8, 9, 11, 13, 16, 17, 18, 19, 20, 21, 22, 23, 24, 25, 26, 27, 28, 29, 32, 33, 34, 35, 36, 37, 39, 40, 43, 44, 46, 47, 48, 49, 50, 52, 53, 54, 55, 57, 58, 59, 61, 62, 63, 64, 65, 66, 67, 68, 71, 72, 73, 78, 79, 80, 81, 82, 83, 84, 85, 86, 87, 89, 91, 92, 93, 94, 95, 97, 98, 99, 100, 103, 105, 106, 107, 109, 110, 111, 112, 114, 115, 116, 117, 118, 120, 121, 122, 123, 128, 129, 130, 131, 132, 133, 137]"
Front-End-Checklist,39183,106,93,13,"[3, 7, 10, 17, 18, 20, 21, 23, 25, 26, 28, 29, 32, 41, 42, 50, 58, 59, 61, 63, 67, 69, 74, 75, 76, 77, 78, 81, 83, 85, 86, 88, 92, 93, 95, 98, 108, 110, 118, 120, 133, 134, 137, 138, 140, 143, 144, 149, 153, 154, 157, 159, 160, 164, 165, 173, 175, 176, 177, 183, 184, 188, 190, 191, 194, 199, 202, 206, 207, 216, 226, 233, 237, 254, 255, 257, 258, 261, 262, 267, 270, 272, 283, 286, 288, 298, 302, 308, 312, 317, 320, 323, 324, 326, 327, 329, 330, 331, 333, 335]"
awesome-public-datasets,39047,88,42,46,"[1, 6, 7, 8, 11, 19, 20, 21, 27, 29, 33, 36, 40, 56, 59, 73, 80, 112, 117, 119, 120, 126, 130, 131, 133, 134, 137, 150, 158, 169, 181, 182, 205, 211, 212, 220, 221, 228, 232, 234, 238, 242, 243, 249, 250, 253, 257, 261, 262, 276, 277, 278, 279, 280, 287, 291, 307, 308, 309, 314, 315, 319, 322, 331, 333, 338, 341, 343, 351, 361, 362, 365, 371, 375, 377, 378, 380, 387, 388, 389, 390, 391, 392, 394, 396, 397, 398, 399]"
normalize.css,38755,458,439,19,"[3, 4, 5, 6, 7, 8, 10, 11, 12, 13, 16, 17, 18, 19, 20, 21, 23, 24, 25, 27, 28, 29, 34, 36, 39, 40, 41, 43, 44, 46, 47, 49, 50, 51, 52, 53, 55, 59, 60, 61, 62, 63, 64, 65, 66, 68, 69, 70, 71, 72, 73, 74, 75, 77, 78, 80, 83, 84, 85, 87, 88, 94, 96, 97, 98, 100, 101, 102, 110, 112, 113, 114, 115, 116, 117, 118, 119, 120, 121, 122, 123, 125, 126, 129, 130, 135, 137, 138, 139, 143, 144, 148, 149, 150, 151, 152, 153, 154, 155, 157]"
yarn,38415,5784,3679,2105,"[1, 2, 3, 4, 5, 6, 7, 8, 9, 10, 11, 12, 13, 14, 15, 16, 17, 18, 19, 20, 21, 22, 23, 24, 25, 26, 27, 28, 29, 30, 31, 32, 33, 34, 35, 37, 38, 39, 40, 41, 42, 43, 44, 45, 46, 47, 48, 49, 50, 51, 52, 53, 54, 55, 57, 59, 61, 62, 63, 67, 68, 69, 70, 71, 74, 75, 77, 78, 79, 80, 81, 83, 84, 85, 86, 87, 88, 91, 93, 94, 97, 98, 102, 103, 104, 106, 107, 110, 112, 113, 114, 115, 116, 117, 118, 120, 121, 122, 123, 124]"
pytorch,38390,13944,9647,4297,"[1, 2, 3, 5, 6, 7, 10, 13, 16, 17, 18, 20, 21, 23, 25, 26, 27, 28, 29, 30, 31, 32, 35, 39, 41, 42, 43, 46, 48, 49, 54, 60, 63, 67, 76, 81, 82, 83, 84, 85, 86, 87, 88, 89, 91, 92, 94, 95, 97, 101, 102, 104, 108, 109, 111, 114, 120, 121, 122, 123, 124, 125, 130, 134, 138, 139, 140, 141, 143, 144, 145, 146, 147, 148, 149, 150, 151, 153, 156, 157, 158, 159, 160, 163, 165, 166, 168, 175, 181, 182, 184, 186, 187, 188, 190, 191, 199, 206, 211, 215]"
fucking-algorithm,38022,164,132,32,"[1, 2, 3, 4, 5, 6, 7, 8, 9, 10, 11, 12, 13, 14, 15, 16, 17, 18, 19, 20, 21, 22, 23, 24, 25, 26, 27, 28, 29, 30, 31, 32, 33, 34, 35, 36, 37, 38, 39, 40, 41, 42, 43, 44, 45, 46, 47, 48, 49, 50, 51, 52, 53, 54, 55, 56, 57, 59, 62, 63, 65, 66, 67, 68, 69, 72, 73, 74, 75, 76, 77, 79, 83, 84, 85, 86, 96, 100, 101, 105, 109, 110, 112, 119, 126, 127, 129, 131, 137, 140, 148, 150, 152, 155, 157, 159, 161, 163, 164, 165]"
awesome-android-ui,37806,0,0,0,[]
hacker-scripts,37798,56,24,32,"[2, 3, 4, 9, 12, 14, 23, 26, 27, 28, 30, 33, 34, 35, 38, 42, 43, 48, 51, 53, 55, 57, 61, 65, 83, 87, 91, 92, 95, 114, 117, 122, 133, 140, 142, 143, 145, 146, 147, 148, 149, 153, 154, 157, 160, 162, 165, 168, 169, 171, 172, 176, 177, 181, 189, 191]"
gin,37753,1372,1159,213,"[9, 10, 12, 14, 15, 19, 20, 22, 24, 27, 29, 35, 38, 42, 43, 44, 45, 48, 49, 51, 53, 54, 55, 57, 59, 61, 63, 64, 65, 66, 72, 75, 77, 78, 84, 85, 86, 87, 90, 92, 93, 94, 95, 96, 100, 104, 106, 107, 108, 109, 111, 113, 114, 115, 116, 117, 118, 119, 124, 125, 126, 127, 128, 129, 130, 131, 133, 134, 135, 136, 137, 138, 140, 143, 145, 146, 147, 148, 149, 150, 151, 152, 153, 154, 155, 156, 158, 159, 160, 161, 162, 163, 164, 165, 166, 167, 169, 170, 171, 172]"
DeepLearning-500-questions,37706,151,75,76,"[1, 2, 5, 6, 7, 10, 17, 18, 22, 54, 65, 68, 73, 74, 75, 76, 77, 78, 79, 80, 81, 86, 89, 93, 95, 96, 100, 107, 111, 113, 115, 123, 124, 126, 128, 129, 132, 134, 138, 140, 153, 154, 155, 157, 158, 162, 174, 187, 188, 196, 197, 198, 204, 212, 218, 219, 221, 222, 226, 228, 229, 230, 232, 233, 234, 236, 239, 241, 242, 244, 247, 248, 250, 251, 252, 254, 255, 257, 258, 263, 267, 269, 270, 273, 274, 275, 280, 287, 299, 311, 312, 316, 325, 330, 340, 349, 360, 363, 370, 371]"
awesome-mac,37540,261,209,52,"[2, 5, 9, 11, 12, 16, 17, 19, 20, 21, 23, 28, 30, 32, 35, 37, 38, 42, 43, 55, 57, 58, 59, 60, 62, 64, 70, 75, 76, 79, 81, 84, 85, 87, 95, 96, 97, 98, 104, 108, 109, 112, 113, 114, 119, 121, 122, 130, 132, 133, 134, 136, 137, 139, 140, 141, 143, 152, 153, 154, 155, 156, 160, 161, 167, 168, 170, 171, 172, 176, 177, 178, 182, 188, 192, 193, 194, 196, 198, 199, 200, 201, 204, 206, 207, 209, 212, 213, 215, 217, 225, 226, 227, 228, 230, 231, 233, 236, 237, 245]"
materialize,37475,5118,4540,578,"[5, 7, 8, 9, 11, 13, 14, 15, 16, 17, 18, 19, 20, 21, 22, 23, 24, 25, 26, 27, 28, 29, 30, 31, 32, 33, 34, 36, 37, 38, 39, 40, 41, 42, 43, 44, 45, 46, 47, 48, 49, 50, 51, 52, 53, 54, 55, 56, 57, 58, 59, 60, 61, 62, 63, 65, 67, 68, 69, 71, 72, 73, 74, 76, 77, 79, 80, 81, 82, 83, 87, 88, 90, 92, 93, 94, 95, 96, 97, 98, 99, 101, 102, 103, 105, 107, 108, 109, 110, 113, 115, 116, 117, 118, 119, 120, 125, 126, 127, 128]"
TensorFlow-Examples,37192,208,61,147,"[2, 6, 8, 9, 10, 11, 12, 13, 14, 15, 16, 19, 20, 21, 22, 23, 25, 26, 27, 28, 30, 35, 36, 37, 38, 39, 40, 41, 42, 44, 45, 47, 48, 49, 50, 60, 61, 62, 65, 66, 67, 68, 70, 72, 73, 74, 75, 76, 78, 79, 80, 81, 83, 84, 86, 87, 88, 89, 90, 91, 92, 97, 102, 106, 109, 110, 111, 114, 117, 118, 119, 120, 123, 127, 132, 133, 134, 135, 137, 138, 139, 141, 144, 145, 148, 150, 151, 153, 154, 155, 156, 161, 163, 170, 171, 175, 176, 179, 180, 181]"
guava,37062,3112,2481,631,"[1, 2, 3, 4, 5, 6, 7, 8, 9, 10, 11, 12, 13, 14, 15, 16, 17, 18, 19, 20, 21, 22, 23, 24, 25, 26, 27, 28, 29, 30, 31, 32, 33, 34, 35, 36, 37, 38, 39, 40, 41, 42, 43, 44, 45, 46, 47, 48, 49, 50, 51, 52, 53, 54, 55, 56, 57, 58, 59, 60, 61, 62, 63, 64, 65, 66, 67, 68, 69, 70, 71, 72, 73, 74, 75, 76, 77, 78, 79, 80, 81, 82, 83, 84, 85, 86, 87, 88, 89, 90, 91, 92, 93, 94, 95, 96, 97, 98, 99, 100]"
scrapy,37003,2175,1738,437,"[7, 8, 9, 10, 11, 12, 13, 14, 15, 16, 17, 18, 19, 20, 21, 22, 23, 24, 25, 26, 27, 28, 29, 30, 31, 32, 33, 34, 35, 36, 37, 40, 41, 43, 47, 49, 50, 52, 53, 58, 63, 64, 70, 71, 72, 73, 76, 82, 83, 84, 85, 86, 87, 89, 92, 100, 101, 102, 104, 105, 107, 110, 112, 113, 118, 120, 122, 123, 124, 125, 126, 131, 133, 136, 137, 141, 142, 144, 150, 153, 156, 157, 158, 159, 161, 162, 163, 166, 169, 170, 173, 178, 180, 182, 183, 184, 187, 188, 191, 193]"
Awesome-Hacking,36953,0,0,0,[]
okhttp,36916,3059,2988,71,"[15, 17, 18, 19, 32, 50, 51, 57, 81, 82, 83, 90, 95, 97, 104, 105, 106, 108, 109, 110, 111, 112, 113, 114, 115, 116, 128, 131, 137, 139, 145, 149, 151, 154, 163, 164, 167, 173, 175, 177, 179, 180, 181, 182, 183, 184, 187, 189, 190, 191, 193, 195, 198, 200, 202, 205, 206, 207, 214, 215, 219, 220, 221, 223, 224, 226, 227, 228, 229, 230, 240, 242, 251, 252, 256, 257, 258, 259, 260, 262, 264, 265, 268, 269, 270, 271, 272, 273, 274, 278, 281, 282, 285, 288, 290, 291, 292, 293, 294, 296]"
freecodecamp.cn,36829,585,442,143,"[1, 2, 3, 4, 5, 6, 7, 8, 9, 10, 11, 12, 13, 14, 15, 16, 17, 18, 19, 20, 21, 22, 23, 24, 25, 26, 27, 28, 29, 30, 31, 32, 33, 34, 35, 36, 37, 38, 39, 40, 41, 42, 43, 44, 45, 46, 47, 48, 49, 50, 51, 52, 53, 54, 55, 56, 57, 58, 59, 60, 61, 62, 63, 64, 65, 66, 67, 68, 69, 70, 71, 72, 73, 74, 75, 76, 77, 78, 79, 80, 81, 82, 83, 84, 85, 86, 87, 88, 89, 90, 91, 92, 93, 94, 95, 96, 97, 98, 99, 100]"
spring-framework,36794,19437,18572,865,"[195, 197, 207, 209, 228, 240, 262, 275, 279, 281, 289, 4732, 4733, 4734, 4735, 4736, 4737, 4738, 4739, 4740, 4741, 4742, 4743, 4744, 4745, 4746, 4747, 4748, 4749, 4750, 4751, 4752, 4753, 4754, 4755, 4756, 4757, 4758, 4759, 4760, 4761, 4762, 4763, 4764, 4765, 4766, 4767, 4768, 4769, 4770, 4771, 4772, 4773, 4774, 4775, 4776, 4777, 4778, 4779, 4780, 4781, 4782, 4783, 4784, 4785, 4786, 4787, 4788, 4789, 4790, 4791, 4792, 4793, 4794, 4795, 4796, 4797, 4798, 4799, 4800, 4801, 4802, 4803, 4804, 4805, 4806, 4807, 4808, 4809, 4810, 4811, 4812, 4813, 4814, 4815, 4816, 4817, 4818, 4819, 4820]"
nw.js,36774,6644,5890,754,"[1, 2, 3, 4, 6, 7, 8, 9, 10, 11, 12, 13, 14, 15, 16, 17, 18, 19, 20, 21, 22, 24, 25, 26, 27, 28, 29, 30, 31, 32, 33, 34, 35, 36, 37, 38, 39, 40, 41, 42, 43, 44, 45, 46, 47, 48, 49, 50, 52, 53, 54, 55, 56, 57, 58, 59, 60, 61, 62, 63, 64, 65, 66, 67, 68, 69, 70, 71, 72, 73, 74, 75, 76, 77, 78, 79, 80, 81, 82, 83, 84, 85, 86, 87, 88, 89, 90, 91, 92, 93, 94, 95, 96, 97, 98, 99, 100, 101, 102, 103]"
awesome-react,36756,62,60,2,"[32, 58, 91, 111, 129, 164, 167, 172, 197, 203, 214, 218, 268, 307, 315, 319, 328, 366, 376, 386, 431, 477, 483, 485, 486, 503, 530, 535, 549, 565, 573, 598, 599, 603, 621, 625, 634, 642, 644, 731, 743, 752, 795, 805, 810, 842, 876, 887, 895, 905, 909, 914, 931, 937, 966, 980, 997, 1021, 1035, 1049, 1072, 1078]"
neovim,36470,5471,4633,838,"[3, 4, 10, 12, 16, 17, 18, 19, 21, 23, 24, 25, 26, 27, 29, 30, 31, 34, 37, 38, 39, 40, 41, 42, 43, 46, 50, 51, 53, 56, 58, 59, 60, 63, 64, 66, 67, 68, 69, 71, 72, 74, 77, 78, 80, 84, 88, 89, 92, 94, 96, 97, 100, 101, 102, 103, 104, 106, 107, 110, 111, 118, 119, 126, 127, 132, 133, 135, 137, 138, 140, 141, 143, 145, 149, 153, 159, 161, 162, 165, 167, 168, 169, 170, 171, 173, 174, 175, 176, 177, 178, 179, 181, 186, 188, 193, 194, 195, 196, 202]"
babel,36460,7075,6459,616,"[1, 2, 5, 6, 7, 8, 9, 10, 11, 12, 13, 14, 15, 16, 17, 19, 20, 21, 22, 23, 24, 25, 26, 27, 28, 29, 30, 31, 32, 33, 34, 37, 38, 39, 40, 41, 42, 43, 44, 45, 47, 49, 51, 52, 53, 55, 56, 57, 58, 60, 61, 62, 64, 65, 66, 67, 68, 69, 71, 72, 73, 74, 76, 77, 78, 79, 81, 82, 85, 86, 87, 88, 89, 90, 91, 93, 94, 95, 96, 97, 98, 99, 100, 101, 102, 104, 105, 106, 107, 108, 109, 110, 111, 113, 114, 116, 117, 119, 120, 121]"
prettier,36386,4184,3539,645,"[2, 6, 7, 8, 10, 12, 13, 14, 15, 16, 17, 18, 19, 20, 21, 22, 23, 24, 25, 26, 27, 28, 29, 30, 31, 32, 34, 35, 36, 37, 38, 39, 40, 42, 43, 44, 46, 49, 52, 53, 54, 55, 56, 58, 59, 60, 61, 62, 63, 65, 66, 68, 69, 71, 73, 74, 77, 78, 79, 80, 81, 82, 87, 88, 89, 91, 92, 93, 94, 95, 96, 98, 99, 100, 103, 110, 112, 115, 118, 120, 121, 127, 129, 130, 135, 136, 139, 140, 145, 146, 147, 149, 150, 151, 152, 154, 155, 158, 159, 160]"
architecture-samples,36295,381,272,109,"[3, 4, 5, 6, 7, 9, 10, 13, 15, 19, 21, 22, 23, 24, 25, 27, 31, 33, 34, 38, 39, 40, 42, 43, 44, 46, 47, 49, 50, 53, 57, 58, 59, 63, 64, 65, 68, 70, 72, 73, 77, 78, 82, 83, 84, 85, 86, 87, 88, 89, 91, 92, 93, 94, 95, 96, 97, 98, 99, 100, 101, 102, 103, 104, 105, 106, 108, 110, 111, 114, 115, 116, 117, 120, 121, 123, 124, 125, 127, 129, 132, 133, 134, 135, 136, 137, 138, 139, 142, 145, 154, 155, 156, 157, 160, 161, 163, 164, 168, 169]"
big-list-of-naughty-strings,35715,71,27,44,"[13, 14, 16, 20, 25, 28, 33, 40, 44, 46, 48, 52, 55, 58, 62, 63, 67, 70, 72, 75, 79, 80, 86, 87, 88, 91, 97, 99, 100, 101, 104, 105, 107, 111, 112, 113, 114, 117, 123, 126, 130, 132, 136, 137, 138, 139, 142, 148, 151, 153, 154, 157, 166, 168, 170, 171, 174, 177, 178, 183, 184, 186, 187, 188, 190, 194, 197, 199, 201, 202, 203]"
serverless,35693,4339,3569,770,"[1, 2, 5, 6, 7, 10, 13, 14, 15, 17, 19, 21, 22, 23, 25, 26, 27, 28, 29, 30, 31, 32, 34, 35, 36, 39, 41, 43, 44, 46, 47, 49, 50, 51, 52, 53, 56, 57, 60, 61, 65, 66, 72, 79, 80, 83, 85, 91, 96, 101, 105, 106, 107, 109, 120, 121, 123, 126, 127, 129, 130, 131, 132, 135, 136, 138, 139, 140, 145, 147, 148, 149, 151, 152, 154, 156, 158, 160, 161, 162, 163, 164, 165, 167, 168, 173, 174, 176, 177, 178, 180, 181, 182, 183, 184, 185, 187, 192, 198, 199]"
impress.js,35659,436,392,44,"[4, 5, 6, 7, 8, 9, 10, 11, 12, 13, 18, 19, 20, 22, 23, 25, 26, 27, 28, 29, 31, 32, 35, 37, 39, 40, 44, 46, 47, 55, 57, 67, 69, 73, 78, 79, 80, 81, 85, 86, 88, 92, 96, 98, 99, 100, 102, 104, 109, 110, 111, 113, 114, 115, 116, 118, 119, 122, 124, 125, 126, 127, 128, 130, 132, 133, 135, 136, 138, 139, 140, 141, 142, 144, 145, 147, 148, 150, 151, 159, 161, 162, 163, 164, 165, 166, 167, 168, 169, 171, 172, 173, 174, 175, 178, 179, 180, 181, 183, 184]"
awesome-nodejs,35623,89,89,0,"[29, 48, 80, 87, 104, 107, 114, 119, 124, 125, 126, 127, 131, 139, 140, 141, 158, 162, 181, 190, 200, 202, 205, 223, 252, 284, 285, 301, 305, 309, 332, 333, 348, 352, 382, 396, 432, 457, 483, 488, 494, 503, 507, 515, 522, 527, 544, 575, 580, 588, 612, 613, 642, 650, 653, 655, 659, 664, 681, 683, 694, 701, 707, 711, 717, 723, 734, 752, 766, 775, 778, 792, 802, 810, 819, 820, 824, 844, 849, 854, 881, 885, 888, 897, 939, 944, 987, 1007, 1011]"
parcel,35613,2955,2406,549,"[1, 2, 3, 4, 5, 6, 7, 8, 9, 10, 11, 12, 13, 14, 15, 16, 17, 18, 19, 20, 21, 23, 24, 25, 28, 29, 30, 31, 33, 34, 36, 37, 39, 40, 41, 42, 43, 44, 46, 47, 49, 51, 52, 53, 54, 55, 56, 57, 60, 61, 62, 64, 65, 66, 68, 69, 70, 71, 72, 73, 77, 79, 80, 82, 83, 86, 87, 88, 89, 91, 93, 94, 95, 96, 97, 99, 100, 101, 102, 103, 105, 106, 107, 108, 109, 110, 111, 112, 113, 117, 119, 120, 124, 125, 126, 129, 131, 133, 134, 135]"
retrofit,35533,2359,2272,87,"[1, 63, 64, 65, 76, 78, 79, 80, 96, 99, 101, 103, 105, 111, 112, 113, 114, 117, 118, 119, 120, 122, 123, 130, 131, 133, 134, 135, 137, 139, 140, 141, 142, 146, 151, 154, 161, 162, 163, 166, 178, 181, 184, 185, 188, 191, 193, 194, 197, 198, 199, 203, 204, 206, 208, 210, 211, 212, 213, 219, 220, 221, 222, 224, 227, 228, 231, 232, 234, 235, 236, 237, 238, 239, 240, 241, 242, 244, 247, 250, 256, 257, 261, 262, 263, 264, 265, 266, 275, 277, 281, 282, 283, 284, 285, 290, 291, 292, 293, 295]"
frp,35528,1423,1377,46,"[14, 18, 19, 20, 21, 23, 26, 28, 30, 31, 34, 35, 36, 37, 42, 43, 44, 53, 56, 57, 58, 59, 60, 61, 62, 67, 68, 69, 70, 72, 75, 79, 80, 81, 82, 83, 84, 85, 86, 87, 92, 93, 96, 97, 98, 99, 100, 102, 103, 104, 105, 106, 107, 108, 109, 110, 111, 113, 114, 115, 116, 117, 118, 119, 120, 121, 122, 123, 124, 125, 126, 127, 128, 129, 130, 131, 132, 133, 134, 135, 136, 137, 138, 139, 140, 141, 142, 143, 144, 145, 146, 147, 148, 149, 150, 151, 153, 154, 155, 156]"
clean-code-javascript,35503,91,61,30,"[2, 4, 5, 23, 25, 30, 31, 40, 41, 42, 45, 49, 50, 52, 55, 59, 70, 71, 74, 75, 78, 85, 107, 108, 112, 113, 115, 122, 125, 126, 129, 130, 131, 133, 135, 136, 138, 143, 146, 148, 150, 158, 159, 160, 161, 162, 163, 168, 175, 180, 181, 184, 185, 190, 199, 200, 201, 203, 205, 212, 214, 230, 231, 235, 236, 237, 241, 242, 245, 249, 250, 252, 260, 266, 271, 275, 278, 281, 282, 285, 286, 292, 293, 294, 295, 296, 298, 299, 308, 309, 314]"
anime,35280,533,436,97,"[4, 11, 13, 14, 15, 18, 19, 20, 24, 25, 28, 29, 31, 34, 35, 37, 38, 39, 40, 41, 42, 43, 44, 45, 46, 47, 48, 49, 50, 52, 54, 55, 56, 57, 58, 59, 60, 61, 62, 63, 64, 66, 70, 71, 72, 73, 74, 75, 76, 77, 78, 79, 80, 81, 82, 83, 85, 87, 89, 90, 91, 92, 93, 94, 95, 96, 97, 98, 99, 100, 101, 102, 104, 105, 108, 109, 110, 111, 112, 113, 114, 115, 116, 117, 118, 119, 121, 122, 123, 124, 125, 126, 127, 128, 130, 131, 132, 133, 134, 135]"
node-v0.x-archive,35172,6383,5848,535,"[1, 2, 3, 4, 5, 6, 7, 8, 9, 10, 11, 12, 13, 14, 15, 16, 17, 18, 19, 20, 21, 22, 23, 24, 25, 26, 27, 28, 29, 30, 31, 32, 33, 34, 35, 36, 37, 38, 39, 40, 41, 42, 43, 44, 45, 46, 47, 48, 49, 50, 51, 52, 53, 54, 55, 56, 57, 58, 59, 60, 61, 62, 63, 64, 65, 66, 67, 68, 69, 70, 71, 72, 74, 75, 76, 77, 78, 79, 80, 81, 82, 83, 84, 85, 86, 87, 88, 89, 90, 91, 92, 93, 94, 95, 96, 97, 98, 99, 100, 101]"
x64dbg,35050,1782,1404,378,"[1, 2, 3, 4, 5, 6, 7, 8, 9, 10, 11, 12, 13, 14, 15, 16, 17, 18, 19, 20, 21, 22, 23, 24, 25, 26, 27, 28, 29, 30, 31, 32, 33, 34, 35, 36, 37, 38, 39, 40, 41, 42, 43, 44, 45, 46, 47, 48, 49, 50, 51, 52, 53, 54, 55, 56, 57, 58, 59, 60, 61, 62, 63, 64, 65, 66, 67, 68, 69, 70, 71, 72, 73, 74, 75, 76, 77, 78, 79, 80, 81, 82, 83, 84, 85, 86, 87, 88, 89, 90, 91, 92, 93, 94, 95, 96, 97, 98, 99, 100]"
free-for-dev,34957,0,0,0,[]
awesome-ios,34789,430,430,0,"[5, 9, 28, 33, 36, 37, 44, 66, 70, 75, 94, 122, 135, 173, 179, 199, 205, 232, 260, 263, 266, 293, 301, 313, 314, 315, 316, 317, 318, 319, 334, 342, 343, 348, 359, 363, 364, 365, 369, 370, 371, 372, 373, 374, 380, 381, 394, 395, 407, 409, 410, 411, 412, 413, 414, 438, 442, 445, 450, 453, 459, 460, 461, 463, 469, 477, 478, 491, 499, 500, 501, 502, 504, 505, 507, 511, 514, 515, 517, 518, 519, 520, 524, 525, 526, 527, 528, 538, 539, 540, 541, 542, 543, 544, 545, 546, 547, 548, 549, 552]"
grafana,34782,15784,13245,2539,"[1, 2, 3, 4, 5, 6, 8, 9, 10, 11, 12, 13, 14, 15, 16, 17, 18, 19, 20, 22, 24, 25, 27, 28, 31, 32, 34, 35, 36, 38, 40, 41, 42, 43, 44, 45, 46, 47, 48, 49, 50, 52, 53, 54, 56, 57, 59, 60, 61, 62, 64, 65, 66, 67, 68, 69, 70, 71, 72, 73, 74, 75, 77, 78, 79, 80, 81, 82, 83, 84, 86, 87, 88, 89, 90, 91, 92, 93, 94, 95, 96, 97, 98, 99, 100, 101, 102, 103, 104, 105, 106, 107, 108, 109, 110, 111, 112, 113, 114, 115]"
learn-regex,34732,68,32,36,"[4, 5, 7, 11, 12, 13, 16, 17, 18, 21, 22, 26, 29, 30, 34, 36, 37, 38, 40, 45, 50, 54, 60, 65, 68, 70, 72, 78, 81, 83, 85, 86, 90, 93, 101, 103, 108, 111, 114, 120, 121, 122, 123, 127, 139, 140, 142, 151, 159, 161, 162, 165, 166, 167, 168, 169, 173, 174, 183, 185, 186, 188, 190, 192, 194, 195, 198, 205]"
build-web-application-with-golang,34570,277,170,107,"[6, 12, 16, 30, 35, 36, 37, 38, 39, 50, 51, 55, 59, 65, 92, 108, 112, 127, 140, 141, 146, 148, 150, 158, 161, 162, 163, 164, 165, 166, 167, 168, 172, 175, 177, 180, 192, 196, 208, 210, 215, 224, 229, 230, 231, 236, 237, 241, 242, 246, 247, 248, 256, 258, 259, 260, 261, 262, 265, 276, 278, 280, 282, 283, 284, 285, 288, 292, 293, 294, 297, 318, 320, 325, 326, 329, 331, 332, 334, 335, 336, 337, 346, 347, 350, 351, 352, 354, 356, 371, 373, 378, 382, 384, 385, 386, 388, 390, 391, 392]"
AdminLTE,34331,2149,2104,45,"[1, 2, 3, 4, 5, 6, 7, 8, 9, 10, 11, 12, 13, 14, 15, 17, 18, 19, 22, 23, 24, 25, 26, 28, 30, 32, 34, 35, 38, 39, 40, 41, 43, 44, 45, 47, 48, 49, 50, 51, 52, 53, 54, 55, 57, 58, 59, 60, 63, 64, 65, 66, 68, 69, 70, 71, 72, 74, 76, 77, 78, 79, 80, 81, 83, 84, 86, 88, 89, 90, 93, 94, 95, 100, 101, 103, 104, 105, 106, 107, 108, 109, 110, 111, 112, 113, 114, 115, 116, 117, 119, 120, 121, 122, 123, 124, 126, 127, 128, 129]"
tesseract,34211,1822,1541,281,"[1, 3, 4, 5, 20, 21, 22, 34, 37, 40, 41, 42, 44, 47, 48, 49, 50, 53, 57, 58, 59, 61, 63, 64, 66, 67, 68, 70, 71, 72, 73, 74, 75, 76, 77, 78, 79, 82, 83, 85, 88, 93, 94, 96, 97, 98, 99, 100, 101, 102, 103, 104, 110, 111, 112, 113, 114, 115, 116, 117, 118, 120, 121, 122, 123, 124, 128, 129, 130, 131, 134, 135, 138, 139, 140, 142, 146, 147, 150, 151, 152, 153, 160, 161, 165, 166, 168, 169, 170, 171, 172, 174, 178, 181, 182, 183, 184, 185, 186, 187]"
gogs,34206,4529,3877,652,"[1, 2, 3, 4, 5, 6, 7, 8, 9, 10, 11, 12, 13, 14, 15, 16, 17, 18, 19, 20, 21, 22, 23, 24, 25, 26, 27, 28, 29, 30, 34, 37, 38, 39, 41, 42, 43, 44, 45, 46, 49, 52, 53, 54, 56, 57, 58, 59, 63, 64, 65, 66, 67, 69, 74, 76, 80, 81, 82, 84, 86, 88, 89, 91, 92, 93, 94, 96, 97, 98, 99, 101, 102, 106, 107, 108, 110, 115, 116, 117, 118, 119, 121, 122, 123, 125, 126, 127, 128, 130, 131, 136, 137, 138, 139, 140, 141, 144, 145, 148]"
awesome-interview-questions,33992,22,19,3,"[1, 14, 15, 20, 21, 22, 37, 39, 42, 50, 71, 73, 106, 116, 117, 126, 140, 144, 149, 157, 161, 169]"
mall,33961,271,258,13,"[1, 2, 3, 4, 5, 6, 7, 8, 9, 10, 11, 12, 13, 14, 15, 16, 18, 19, 20, 21, 22, 23, 26, 28, 29, 30, 31, 32, 33, 35, 36, 37, 38, 39, 40, 41, 42, 43, 44, 45, 48, 49, 50, 51, 52, 53, 54, 55, 57, 58, 59, 60, 61, 62, 64, 66, 67, 68, 69, 70, 71, 72, 74, 75, 76, 77, 78, 79, 80, 81, 83, 84, 85, 86, 87, 89, 90, 92, 93, 94, 95, 96, 97, 98, 100, 101, 102, 103, 104, 105, 106, 107, 111, 112, 113, 114, 116, 117, 120, 121]"
face_recognition,33950,979,508,471,"[1, 2, 3, 4, 6, 9, 10, 11, 12, 13, 14, 17, 18, 21, 22, 23, 24, 26, 27, 28, 29, 30, 31, 32, 33, 34, 36, 37, 38, 40, 43, 44, 45, 46, 48, 51, 53, 56, 57, 58, 59, 60, 61, 62, 63, 64, 67, 68, 69, 70, 71, 72, 73, 74, 75, 76, 77, 78, 79, 80, 81, 82, 83, 84, 85, 86, 87, 88, 89, 90, 91, 92, 93, 94, 95, 96, 97, 98, 99, 100, 101, 102, 103, 104, 105, 106, 107, 109, 111, 113, 114, 115, 116, 117, 118, 119, 120, 121, 122, 123]"
git-flight-rules,33617,54,46,8,"[2, 3, 4, 6, 8, 10, 20, 26, 30, 33, 37, 40, 54, 59, 62, 76, 85, 90, 97, 107, 112, 118, 120, 130, 132, 135, 150, 155, 162, 173, 184, 192, 193, 194, 204, 207, 209, 211, 214, 216, 222, 225, 230, 234, 264, 267, 268, 272, 276, 277, 284, 288, 291, 293]"
Ghost,33544,5737,5686,51,"[1, 2, 3, 4, 5, 6, 7, 8, 9, 10, 11, 12, 13, 14, 15, 16, 17, 18, 19, 20, 21, 22, 24, 25, 26, 27, 28, 29, 31, 33, 34, 35, 36, 37, 38, 39, 40, 41, 42, 43, 44, 45, 46, 47, 48, 49, 53, 58, 64, 65, 66, 73, 79, 82, 83, 86, 91, 93, 98, 99, 101, 102, 103, 104, 106, 107, 110, 112, 115, 116, 117, 118, 124, 125, 128, 129, 132, 133, 134, 135, 136, 137, 138, 139, 142, 146, 147, 148, 149, 150, 151, 153, 154, 157, 165, 169, 171, 172, 173, 174]"
Alamofire,33433,2334,2315,19,"[1, 2, 7, 8, 10, 11, 13, 14, 16, 17, 19, 22, 25, 27, 28, 29, 32, 33, 35, 36, 37, 43, 44, 45, 47, 51, 53, 54, 55, 56, 57, 58, 62, 63, 64, 65, 68, 70, 71, 72, 74, 75, 76, 79, 80, 81, 83, 84, 86, 89, 91, 92, 95, 96, 99, 100, 101, 103, 106, 107, 110, 111, 112, 113, 115, 116, 117, 119, 121, 122, 124, 126, 128, 131, 132, 134, 135, 136, 141, 144, 146, 147, 148, 149, 150, 151, 152, 154, 155, 156, 157, 158, 161, 162, 163, 164, 165, 166, 169, 170]"
svelte,33420,2746,2346,400,"[1, 2, 3, 4, 5, 6, 7, 8, 9, 10, 11, 12, 13, 14, 15, 16, 17, 18, 19, 20, 21, 22, 23, 24, 25, 26, 27, 29, 30, 32, 33, 34, 35, 36, 37, 39, 40, 41, 42, 43, 44, 45, 46, 47, 48, 50, 51, 52, 53, 54, 55, 56, 57, 58, 59, 60, 61, 62, 63, 64, 65, 66, 67, 68, 69, 73, 74, 75, 77, 80, 81, 84, 85, 87, 88, 90, 92, 93, 96, 98, 99, 100, 102, 104, 106, 108, 109, 113, 114, 118, 119, 123, 126, 127, 128, 129, 130, 133, 136, 137]"
awesome-courses,33211,58,33,25,"[23, 26, 29, 46, 56, 57, 61, 72, 73, 82, 100, 118, 122, 126, 127, 128, 129, 130, 131, 145, 150, 159, 160, 164, 168, 187, 189, 194, 202, 204, 207, 212, 213, 217, 232, 241, 244, 250, 253, 257, 260, 262, 264, 265, 272, 273, 278, 279, 284, 286, 295, 296, 299, 301, 302, 303, 304, 319]"
hyper,33162,2981,2228,753,"[1, 2, 3, 4, 5, 6, 7, 8, 9, 10, 11, 12, 13, 14, 16, 17, 18, 21, 22, 23, 24, 27, 29, 30, 31, 33, 35, 37, 38, 39, 40, 41, 42, 43, 44, 45, 46, 47, 48, 49, 50, 51, 52, 53, 54, 55, 56, 62, 63, 64, 65, 66, 67, 68, 69, 70, 72, 73, 75, 77, 78, 81, 83, 84, 86, 87, 88, 89, 91, 92, 93, 94, 95, 96, 97, 98, 99, 100, 101, 102, 103, 105, 106, 108, 110, 112, 113, 114, 115, 116, 117, 118, 119, 120, 121, 122, 123, 124, 125, 126]"
vue2-elm,33021,490,424,66,"[1, 2, 3, 4, 5, 6, 7, 8, 9, 11, 13, 14, 17, 18, 19, 20, 21, 22, 23, 25, 27, 28, 29, 30, 31, 32, 33, 34, 35, 36, 37, 38, 39, 40, 41, 42, 44, 45, 47, 48, 49, 50, 51, 52, 57, 58, 59, 60, 61, 62, 63, 64, 65, 66, 67, 68, 69, 70, 71, 72, 73, 74, 75, 77, 78, 79, 80, 81, 82, 83, 84, 85, 86, 87, 88, 89, 90, 91, 92, 93, 94, 95, 96, 97, 98, 101, 102, 103, 104, 105, 106, 107, 108, 109, 110, 111, 112, 113, 114, 115]"
core,32992,14224,13257,967,"[4, 6, 7, 8, 9, 10, 13, 16, 18, 20, 28, 31, 32, 33, 37, 43, 61, 72, 74, 75, 76, 82, 83, 84, 93, 102, 103, 104, 105, 106, 123, 129, 137, 139, 140, 151, 154, 159, 161, 162, 171, 175, 176, 178, 181, 184, 195, 196, 198, 200, 201, 204, 206, 213, 218, 219, 221, 230, 231, 232, 235, 237, 240, 245, 247, 248, 255, 256, 262, 264, 269, 274, 280, 281, 287, 288, 293, 298, 306, 310, 311, 313, 314, 317, 319, 321, 325, 329, 330, 332, 333, 334, 336, 338, 344, 349, 361, 362, 365, 367]"
AFNetworking,32723,3021,3006,15,"[7, 8, 10, 11, 12, 13, 14, 16, 17, 19, 20, 21, 23, 26, 27, 29, 30, 31, 32, 33, 34, 36, 37, 39, 42, 45, 47, 50, 51, 55, 56, 58, 59, 62, 64, 65, 66, 67, 69, 72, 74, 77, 78, 79, 80, 82, 83, 86, 89, 92, 93, 94, 97, 98, 100, 101, 102, 103, 104, 105, 108, 109, 110, 111, 114, 116, 120, 122, 124, 128, 130, 132, 137, 138, 141, 143, 149, 151, 155, 159, 166, 170, 171, 173, 175, 176, 177, 179, 183, 185, 187, 188, 189, 190, 193, 194, 196, 198, 200, 206]"
you-get,32662,0,0,0,[]
shadowsocks,32602,0,0,0,[]
git,32425,0,0,0,[]
pm2,32282,3935,3096,839,"[1, 2, 3, 4, 5, 6, 7, 13, 14, 16, 17, 22, 23, 24, 26, 27, 29, 30, 31, 33, 34, 37, 38, 40, 41, 42, 43, 44, 45, 46, 47, 48, 49, 50, 51, 52, 54, 55, 57, 58, 59, 61, 66, 67, 69, 70, 71, 72, 74, 75, 76, 77, 78, 79, 80, 81, 83, 84, 85, 86, 87, 88, 89, 90, 91, 92, 93, 95, 96, 97, 98, 99, 100, 101, 102, 103, 104, 106, 107, 109, 110, 111, 112, 113, 114, 115, 116, 117, 119, 120, 121, 122, 123, 126, 127, 128, 129, 130, 131, 132]"
the-book-of-secret-knowledge,32208,37,36,1,"[2, 8, 10, 12, 20, 21, 24, 26, 27, 31, 34, 36, 49, 50, 53, 54, 60, 65, 73, 74, 88, 91, 92, 99, 100, 107, 115, 126, 129, 133, 134, 137, 144, 155, 165, 166, 168]"
project-based-learning,32159,26,15,11,"[5, 7, 10, 18, 22, 28, 46, 47, 50, 57, 63, 90, 93, 94, 103, 113, 133, 138, 140, 142, 143, 166, 169, 172, 191, 207]"
dubbo,32153,3393,2886,507,"[5, 8, 9, 16, 17, 19, 20, 21, 22, 23, 24, 25, 26, 27, 28, 29, 30, 31, 32, 33, 35, 36, 38, 40, 41, 42, 43, 46, 47, 50, 51, 52, 53, 54, 55, 57, 59, 60, 61, 62, 63, 65, 66, 67, 68, 69, 70, 71, 72, 74, 77, 78, 80, 81, 82, 85, 86, 87, 89, 90, 91, 92, 94, 95, 96, 97, 98, 100, 103, 105, 109, 111, 113, 115, 116, 117, 118, 119, 122, 123, 124, 125, 126, 127, 128, 129, 130, 132, 133, 134, 135, 137, 138, 139, 142, 144, 146, 150, 151, 153]"
gulp,31728,1801,1771,30,"[1, 2, 4, 6, 7, 8, 9, 12, 13, 14, 15, 17, 18, 19, 21, 22, 26, 28, 30, 31, 32, 33, 34, 35, 37, 38, 39, 40, 42, 43, 44, 45, 49, 52, 54, 56, 57, 58, 61, 62, 63, 65, 66, 67, 68, 69, 70, 71, 74, 75, 76, 79, 80, 81, 82, 84, 86, 88, 90, 91, 92, 95, 96, 97, 98, 100, 101, 102, 103, 105, 107, 108, 110, 112, 113, 120, 121, 122, 127, 129, 130, 132, 133, 139, 140, 143, 145, 148, 149, 151, 154, 155, 156, 158, 159, 160, 163, 165, 166, 167]"
33-js-concepts,31703,25,23,2,"[3, 6, 17, 21, 27, 39, 45, 53, 78, 83, 86, 87, 88, 90, 93, 95, 108, 110, 112, 127, 128, 131, 139, 141, 144]"
kotlin,31636,0,0,0,[]
material-design-lite,31585,2144,1787,357,"[1, 2, 3, 4, 5, 6, 7, 8, 9, 10, 11, 12, 15, 17, 18, 19, 20, 21, 25, 26, 28, 29, 30, 31, 32, 33, 34, 35, 36, 37, 38, 39, 40, 41, 42, 43, 45, 46, 47, 48, 49, 50, 51, 64, 66, 67, 68, 69, 70, 75, 77, 78, 79, 80, 82, 83, 84, 87, 89, 90, 92, 93, 94, 95, 96, 97, 98, 99, 100, 101, 102, 103, 104, 105, 107, 108, 109, 111, 112, 113, 114, 115, 120, 123, 125, 126, 127, 128, 129, 130, 131, 132, 133, 134, 136, 137, 138, 142, 144, 145]"
leetcode,31550,157,133,24,"[2, 3, 4, 5, 9, 10, 11, 12, 13, 15, 21, 41, 44, 56, 62, 80, 82, 84, 87, 90, 100, 105, 107, 111, 113, 116, 126, 127, 132, 136, 139, 140, 145, 148, 151, 153, 154, 158, 159, 160, 162, 165, 166, 167, 169, 170, 171, 173, 174, 176, 178, 179, 180, 184, 186, 187, 188, 189, 190, 192, 195, 196, 197, 198, 199, 200, 203, 204, 205, 206, 207, 209, 210, 212, 213, 214, 216, 217, 218, 219, 220, 221, 223, 224, 225, 226, 227, 229, 232, 233, 234, 235, 236, 237, 238, 239, 240, 241, 242, 243]"
Best-websites-a-programmer-should-visit,31501,46,45,1,"[6, 11, 13, 24, 29, 35, 39, 40, 44, 49, 57, 60, 63, 70, 74, 76, 95, 102, 110, 119, 121, 128, 131, 136, 153, 154, 165, 174, 201, 221, 260, 263, 265, 268, 322, 324, 333, 335, 336, 344, 346, 347, 377, 386, 390, 391]"
brackets,31287,9489,6998,2491,"[6, 18, 19, 21, 26, 29, 30, 31, 32, 38, 41, 43, 48, 49, 50, 51, 52, 53, 56, 60, 63, 64, 65, 67, 68, 72, 76, 77, 79, 80, 84, 85, 86, 87, 88, 91, 96, 98, 99, 100, 102, 103, 104, 105, 106, 109, 111, 112, 115, 117, 119, 121, 122, 127, 129, 130, 132, 133, 136, 137, 138, 139, 140, 141, 142, 143, 144, 145, 146, 148, 149, 150, 151, 152, 153, 154, 155, 156, 157, 158, 159, 162, 163, 164, 168, 169, 172, 179, 181, 187, 191, 192, 193, 197, 198, 203, 204, 205, 208, 210]"
awesome-wechat-weapp,31182,0,0,0,[]
syncthing,31052,4049,3791,258,"[1, 2, 3, 4, 5, 7, 8, 9, 10, 11, 12, 13, 14, 15, 16, 17, 19, 20, 21, 22, 23, 24, 25, 26, 27, 30, 31, 32, 33, 34, 35, 36, 37, 38, 39, 40, 41, 42, 43, 44, 45, 46, 47, 48, 49, 50, 51, 52, 53, 54, 55, 56, 57, 58, 59, 60, 61, 62, 63, 64, 65, 66, 67, 68, 69, 70, 71, 72, 73, 75, 76, 77, 79, 80, 82, 83, 84, 85, 86, 87, 88, 89, 90, 92, 93, 94, 95, 96, 97, 98, 99, 100, 101, 102, 103, 105, 106, 107, 108, 109]"
v2ray-core,31026,2112,1901,211,"[1, 2, 3, 4, 5, 6, 7, 8, 9, 10, 12, 13, 16, 17, 19, 20, 21, 22, 23, 24, 25, 26, 28, 29, 30, 32, 33, 34, 35, 36, 37, 38, 39, 41, 42, 43, 44, 47, 48, 49, 50, 51, 52, 53, 54, 59, 60, 61, 64, 65, 66, 67, 68, 70, 71, 72, 75, 76, 77, 78, 79, 80, 81, 83, 84, 85, 86, 87, 88, 89, 90, 92, 94, 95, 96, 98, 99, 100, 101, 102, 104, 105, 106, 107, 108, 110, 111, 112, 113, 114, 115, 116, 117, 118, 119, 122, 124, 125, 126, 127]"
etcd,30893,4840,4642,198,"[48, 49, 50, 52, 67, 69, 76, 79, 83, 90, 91, 95, 96, 97, 99, 101, 103, 104, 105, 106, 107, 110, 113, 115, 116, 119, 125, 139, 144, 146, 148, 149, 155, 156, 157, 158, 162, 163, 164, 165, 166, 169, 170, 174, 176, 177, 178, 180, 185, 188, 195, 196, 200, 202, 203, 209, 211, 216, 219, 220, 222, 225, 252, 254, 257, 261, 262, 269, 271, 273, 274, 279, 284, 285, 286, 293, 294, 295, 302, 306, 307, 308, 313, 316, 318, 319, 321, 325, 326, 328, 331, 332, 334, 335, 336, 337, 338, 344, 345, 346]"
cpython,30873,0,0,0,[]
jest,30796,5326,4416,910,"[3, 4, 5, 6, 7, 10, 14, 15, 17, 19, 20, 23, 26, 27, 28, 29, 31, 35, 36, 37, 39, 40, 42, 43, 44, 46, 47, 48, 51, 52, 53, 54, 56, 59, 61, 62, 64, 65, 66, 70, 71, 72, 74, 75, 76, 77, 78, 79, 80, 81, 82, 83, 86, 87, 88, 89, 90, 93, 94, 95, 97, 98, 100, 101, 102, 104, 105, 106, 107, 108, 109, 110, 112, 114, 116, 118, 119, 120, 121, 124, 127, 128, 129, 131, 134, 135, 136, 139, 140, 142, 143, 144, 145, 147, 148, 149, 150, 151, 152, 155]"
jQuery-File-Upload,30650,3218,3173,45,"[1, 2, 3, 4, 5, 6, 7, 8, 9, 10, 11, 12, 13, 14, 15, 16, 17, 18, 19, 20, 21, 22, 23, 24, 25, 26, 27, 28, 29, 30, 31, 32, 33, 34, 35, 36, 37, 38, 39, 40, 41, 42, 44, 45, 46, 47, 48, 49, 51, 52, 53, 54, 55, 56, 57, 58, 59, 61, 62, 63, 64, 65, 66, 67, 68, 69, 70, 71, 72, 73, 74, 75, 76, 77, 78, 79, 80, 81, 82, 83, 84, 85, 86, 87, 88, 89, 90, 91, 92, 93, 94, 95, 96, 97, 98, 99, 100, 101, 102, 103]"
Projects,30639,56,29,27,"[1, 2, 3, 5, 8, 9, 10, 13, 14, 16, 17, 18, 19, 24, 28, 29, 31, 32, 34, 37, 38, 40, 49, 53, 55, 57, 61, 63, 65, 67, 70, 74, 75, 76, 87, 90, 91, 92, 94, 96, 98, 104, 105, 106, 107, 111, 112, 113, 116, 118, 119, 130, 131, 138, 148, 149]"
discourse,30604,0,0,0,[]
prometheus,30590,3317,3040,277,"[4, 6, 7, 8, 9, 10, 11, 12, 13, 14, 15, 16, 17, 18, 19, 21, 25, 26, 29, 31, 33, 36, 39, 40, 41, 47, 50, 54, 68, 77, 78, 89, 106, 108, 114, 119, 125, 127, 129, 135, 136, 137, 144, 146, 147, 148, 153, 155, 157, 159, 168, 172, 173, 178, 180, 181, 183, 184, 185, 186, 202, 206, 214, 216, 217, 220, 229, 230, 231, 235, 237, 238, 239, 240, 241, 248, 255, 261, 264, 274, 275, 287, 292, 296, 302, 304, 307, 308, 309, 310, 324, 325, 329, 332, 345, 360, 363, 364, 367, 368]"
MPAndroidChart,30564,4435,2778,1657,"[1, 2, 3, 4, 5, 6, 7, 8, 9, 10, 11, 12, 13, 14, 15, 16, 18, 19, 21, 22, 23, 24, 25, 26, 27, 28, 32, 33, 36, 37, 38, 39, 40, 41, 42, 43, 44, 45, 46, 47, 48, 49, 50, 51, 53, 54, 55, 57, 58, 59, 60, 61, 63, 64, 65, 66, 67, 68, 69, 70, 71, 72, 73, 74, 75, 76, 77, 78, 79, 80, 81, 83, 84, 85, 86, 87, 88, 89, 90, 92, 93, 94, 95, 96, 97, 98, 99, 100, 101, 102, 103, 104, 105, 106, 107, 108, 109, 110, 111, 112]"
pdf.js,30518,6737,6144,593,"[1, 2, 3, 4, 7, 8, 9, 10, 11, 12, 15, 17, 22, 28, 36, 37, 38, 39, 40, 41, 42, 43, 44, 49, 50, 51, 52, 54, 55, 56, 57, 58, 59, 60, 64, 66, 67, 68, 69, 70, 71, 72, 74, 78, 80, 81, 88, 99, 102, 103, 104, 109, 111, 115, 116, 117, 119, 121, 123, 124, 125, 126, 127, 128, 129, 131, 141, 146, 148, 149, 150, 154, 155, 157, 158, 159, 160, 161, 162, 166, 167, 168, 169, 171, 174, 176, 177, 178, 179, 181, 183, 184, 186, 187, 188, 192, 196, 200, 204, 205]"
code-server,30415,1324,1240,84,"[1, 3, 4, 8, 9, 11, 13, 14, 15, 17, 18, 19, 22, 23, 25, 26, 27, 30, 31, 33, 34, 35, 36, 37, 38, 39, 40, 41, 43, 44, 47, 48, 52, 53, 55, 56, 58, 59, 60, 61, 62, 63, 64, 65, 66, 67, 69, 70, 73, 76, 77, 78, 79, 80, 81, 82, 83, 85, 86, 89, 90, 91, 92, 93, 94, 96, 97, 99, 100, 101, 102, 106, 107, 108, 112, 114, 115, 116, 118, 119, 121, 122, 123, 124, 125, 126, 127, 128, 129, 131, 132, 134, 136, 137, 138, 140, 141, 142, 143, 144]"
hexo,30328,3450,3322,128,"[1, 2, 4, 5, 6, 7, 8, 9, 10, 11, 12, 13, 14, 15, 17, 18, 19, 20, 21, 22, 23, 24, 25, 26, 27, 28, 29, 30, 33, 34, 35, 36, 37, 38, 39, 40, 41, 42, 43, 44, 45, 46, 47, 48, 49, 50, 51, 52, 54, 55, 56, 57, 58, 61, 62, 63, 64, 65, 66, 67, 69, 70, 71, 72, 73, 74, 75, 77, 78, 79, 82, 84, 85, 86, 87, 88, 89, 91, 93, 94, 95, 97, 98, 99, 100, 101, 102, 103, 104, 105, 106, 107, 108, 109, 110, 111, 112, 113, 114, 116]"
faceswap,30310,594,581,13,"[1, 2, 3, 4, 5, 7, 8, 10, 15, 16, 18, 19, 24, 25, 26, 27, 30, 32, 35, 36, 38, 39, 40, 41, 42, 43, 44, 45, 48, 49, 53, 55, 56, 57, 58, 63, 64, 65, 66, 67, 68, 69, 70, 71, 72, 73, 74, 75, 76, 77, 80, 81, 82, 85, 86, 87, 93, 96, 97, 98, 100, 101, 103, 104, 106, 107, 108, 110, 112, 113, 114, 116, 117, 118, 119, 120, 122, 123, 124, 125, 126, 127, 132, 133, 134, 135, 137, 139, 142, 143, 144, 145, 146, 150, 152, 153, 154, 156, 157, 158]"
caffe,30212,4701,3863,838,"[1, 3, 4, 12, 13, 14, 15, 16, 19, 20, 21, 22, 23, 25, 26, 27, 30, 31, 32, 35, 36, 37, 38, 39, 40, 41, 42, 44, 45, 46, 48, 50, 52, 53, 54, 55, 57, 58, 59, 60, 64, 65, 67, 68, 73, 74, 77, 78, 79, 84, 86, 87, 88, 92, 100, 101, 102, 105, 109, 110, 111, 115, 117, 118, 119, 122, 124, 127, 130, 131, 133, 135, 138, 139, 140, 143, 144, 145, 146, 148, 149, 150, 151, 152, 153, 156, 160, 166, 169, 170, 171, 173, 174, 175, 177, 178, 183, 186, 188, 189]"
github-cheat-sheet,30078,43,40,3,"[4, 5, 6, 9, 10, 12, 19, 20, 21, 22, 23, 30, 47, 55, 60, 81, 87, 92, 93, 106, 107, 123, 136, 138, 142, 143, 144, 149, 150, 153, 156, 157, 158, 162, 166, 167, 168, 169, 170, 175, 176, 181, 187]"
XX-Net,30020,12440,4979,7461,"[1, 2, 3, 4, 5, 6, 7, 8, 9, 10, 11, 12, 13, 14, 15, 16, 17, 18, 19, 20, 21, 22, 23, 24, 25, 26, 27, 28, 29, 30, 31, 32, 33, 34, 35, 36, 37, 38, 39, 40, 41, 42, 43, 44, 45, 46, 47, 48, 49, 50, 51, 52, 53, 54, 55, 56, 57, 58, 59, 60, 61, 62, 63, 64, 65, 66, 67, 68, 69, 70, 71, 72, 73, 74, 75, 76, 77, 78, 79, 80, 81, 82, 83, 84, 85, 86, 87, 89, 90, 91, 94, 95, 96, 97, 98, 99, 100, 101, 102, 103]"
hackathon-starter,30019,564,554,10,"[1, 2, 3, 5, 8, 10, 11, 12, 17, 20, 21, 22, 24, 25, 27, 28, 29, 30, 33, 35, 36, 38, 39, 42, 44, 48, 52, 54, 55, 56, 58, 60, 63, 69, 72, 73, 74, 76, 77, 78, 83, 89, 92, 93, 94, 96, 98, 99, 100, 102, 106, 111, 112, 113, 116, 118, 120, 122, 129, 131, 132, 136, 137, 138, 139, 140, 142, 146, 147, 149, 151, 153, 154, 155, 156, 157, 158, 160, 161, 162, 163, 166, 167, 168, 169, 170, 171, 172, 173, 174, 175, 176, 179, 180, 182, 183, 185, 186, 188, 189]"
godot,29995,22644,16825,5819,"[1, 2, 3, 4, 5, 6, 8, 9, 10, 12, 14, 15, 16, 18, 19, 20, 21, 22, 25, 26, 27, 28, 29, 31, 33, 35, 36, 37, 38, 39, 40, 42, 43, 44, 45, 46, 47, 48, 49, 52, 53, 54, 55, 56, 57, 58, 60, 61, 63, 64, 65, 66, 67, 68, 71, 72, 73, 75, 76, 78, 79, 80, 81, 83, 84, 85, 87, 90, 91, 92, 93, 95, 96, 97, 98, 99, 100, 101, 102, 103, 105, 106, 108, 112, 113, 114, 117, 119, 120, 121, 122, 125, 126, 129, 130, 131, 134, 135, 140, 142]"
fullPage.js,29927,3490,3335,155,"[1, 2, 3, 5, 6, 7, 9, 10, 11, 12, 13, 14, 15, 16, 18, 19, 21, 22, 23, 24, 26, 28, 30, 32, 35, 36, 38, 39, 41, 42, 43, 45, 46, 47, 48, 49, 51, 52, 53, 54, 55, 56, 57, 58, 59, 60, 61, 63, 64, 65, 67, 68, 69, 70, 71, 72, 74, 75, 76, 78, 79, 80, 81, 82, 83, 84, 86, 87, 88, 89, 90, 91, 92, 93, 94, 95, 96, 97, 98, 99, 100, 101, 102, 103, 104, 105, 106, 107, 108, 110, 111, 112, 114, 115, 116, 117, 118, 119, 120, 121]"
android-open-project,29864,80,68,12,"[1, 2, 3, 9, 10, 11, 20, 21, 23, 25, 26, 27, 28, 31, 33, 35, 48, 49, 51, 52, 53, 64, 69, 70, 78, 79, 81, 82, 83, 100, 101, 104, 136, 139, 146, 156, 158, 166, 179, 185, 198, 205, 207, 225, 232, 238, 241, 264, 268, 271, 292, 294, 295, 298, 299, 307, 308, 309, 314, 315, 318, 319, 321, 322, 324, 328, 331, 332, 336, 338, 339, 347, 349, 350, 352, 353, 355, 357, 378, 379]"
mermaid,29759,992,833,159,"[2, 3, 4, 5, 6, 7, 8, 9, 10, 11, 15, 16, 17, 18, 19, 20, 21, 22, 23, 24, 25, 26, 27, 28, 29, 30, 31, 34, 35, 36, 37, 38, 39, 40, 41, 42, 44, 45, 46, 47, 48, 49, 50, 51, 52, 53, 54, 55, 58, 59, 64, 65, 67, 68, 70, 71, 73, 74, 80, 82, 84, 85, 87, 91, 92, 95, 97, 98, 99, 102, 103, 106, 108, 109, 110, 111, 113, 115, 117, 118, 120, 121, 122, 123, 124, 125, 126, 127, 128, 129, 130, 131, 132, 133, 138, 140, 141, 142, 143, 144]"
scrcpy,29689,1240,867,373,"[1, 2, 3, 4, 5, 6, 7, 8, 9, 10, 11, 12, 13, 14, 15, 16, 17, 18, 19, 20, 21, 22, 23, 24, 25, 26, 30, 31, 32, 33, 34, 35, 36, 37, 38, 39, 40, 41, 42, 43, 44, 45, 46, 47, 48, 49, 50, 51, 52, 53, 54, 55, 57, 58, 59, 60, 61, 62, 63, 64, 65, 66, 67, 68, 69, 70, 71, 72, 73, 74, 75, 76, 77, 78, 79, 80, 81, 82, 83, 84, 86, 87, 88, 89, 90, 91, 92, 96, 97, 98, 99, 100, 101, 102, 103, 104, 105, 106, 107, 108]"
slate,29685,545,504,41,"[1, 3, 4, 5, 6, 7, 9, 11, 12, 14, 15, 18, 20, 22, 29, 30, 32, 34, 36, 37, 39, 40, 43, 44, 45, 47, 48, 50, 52, 54, 55, 57, 58, 59, 60, 61, 62, 64, 65, 66, 69, 70, 71, 72, 74, 75, 77, 79, 80, 81, 82, 83, 84, 85, 86, 87, 92, 93, 98, 99, 100, 101, 102, 109, 111, 112, 114, 119, 121, 122, 123, 125, 127, 128, 129, 132, 133, 134, 135, 136, 138, 139, 140, 141, 142, 144, 145, 146, 147, 148, 149, 150, 152, 153, 155, 156, 160, 161, 162, 163]"
immutable-js,29620,1164,1022,142,"[1, 2, 4, 8, 10, 11, 12, 13, 15, 16, 18, 19, 20, 21, 22, 23, 24, 27, 28, 29, 31, 32, 33, 35, 36, 37, 38, 39, 40, 42, 43, 44, 45, 46, 47, 51, 52, 53, 54, 55, 57, 60, 61, 63, 64, 65, 66, 67, 68, 70, 72, 73, 74, 75, 76, 77, 78, 80, 81, 82, 83, 84, 85, 86, 87, 88, 89, 91, 92, 93, 95, 96, 97, 98, 99, 100, 101, 105, 106, 107, 108, 109, 110, 111, 112, 113, 114, 115, 117, 120, 121, 122, 123, 124, 125, 127, 128, 129, 131, 133]"
shadowsocks-android,29574,2153,2136,17,"[1, 3, 4, 5, 6, 7, 8, 9, 10, 11, 12, 13, 14, 15, 16, 17, 18, 19, 20, 21, 23, 24, 25, 26, 27, 28, 29, 30, 31, 32, 33, 34, 35, 36, 37, 39, 40, 42, 43, 44, 45, 46, 47, 49, 50, 51, 52, 53, 54, 55, 56, 58, 59, 60, 61, 63, 65, 66, 68, 70, 71, 72, 73, 74, 75, 76, 78, 79, 82, 83, 84, 85, 86, 88, 89, 90, 91, 92, 93, 94, 95, 96, 97, 98, 99, 100, 101, 102, 104, 105, 106, 107, 108, 109, 110, 111, 112, 113, 114, 115]"
HelloGitHub,29534,1179,1170,9,"[1, 3, 4, 5, 6, 7, 8, 9, 10, 11, 12, 14, 15, 16, 17, 18, 19, 20, 21, 22, 25, 27, 28, 30, 31, 32, 33, 34, 35, 36, 37, 38, 39, 40, 41, 42, 44, 45, 46, 47, 48, 49, 50, 51, 52, 53, 55, 56, 57, 58, 59, 60, 61, 62, 63, 64, 65, 66, 67, 68, 69, 70, 71, 72, 73, 74, 75, 76, 77, 78, 79, 80, 82, 83, 84, 85, 86, 87, 88, 89, 90, 91, 92, 93, 94, 95, 96, 97, 98, 99, 100, 101, 102, 103, 104, 105, 106, 107, 108, 109]"
pixi.js,29382,4033,3956,77,"[1, 2, 3, 4, 5, 6, 10, 11, 13, 14, 16, 19, 21, 23, 24, 25, 26, 27, 28, 29, 30, 31, 32, 33, 34, 35, 36, 38, 39, 41, 42, 43, 44, 48, 52, 53, 55, 56, 57, 59, 61, 62, 64, 65, 66, 67, 68, 70, 71, 72, 75, 76, 77, 79, 80, 81, 82, 83, 85, 86, 87, 88, 91, 94, 98, 101, 102, 103, 105, 108, 110, 112, 113, 114, 116, 120, 121, 123, 125, 126, 127, 128, 130, 131, 132, 134, 136, 137, 138, 139, 141, 142, 145, 146, 147, 148, 149, 153, 154, 155]"
styled-components,29214,2088,1978,110,"[1, 2, 3, 4, 5, 6, 7, 8, 12, 13, 14, 16, 17, 27, 28, 36, 39, 45, 49, 50, 51, 52, 59, 60, 62, 64, 66, 67, 68, 69, 70, 71, 72, 73, 74, 75, 76, 81, 82, 83, 85, 87, 88, 89, 94, 95, 97, 99, 101, 102, 106, 107, 108, 109, 111, 115, 118, 120, 123, 124, 125, 128, 129, 130, 134, 135, 138, 139, 140, 141, 142, 143, 144, 145, 146, 147, 149, 150, 151, 154, 157, 158, 162, 167, 168, 170, 173, 174, 176, 177, 178, 179, 180, 182, 184, 185, 188, 193, 195, 196]"
algorithm-visualizer,29137,72,56,16,"[2, 4, 10, 13, 19, 20, 22, 23, 24, 25, 26, 28, 39, 48, 50, 55, 58, 68, 71, 77, 79, 88, 94, 100, 112, 143, 144, 156, 168, 170, 176, 178, 181, 189, 197, 207, 213, 219, 228, 229, 233, 234, 235, 236, 238, 244, 246, 248, 252, 254, 255, 256, 260, 261, 263, 264, 267, 268, 271, 272, 273, 275, 276, 277, 278, 281, 282, 283, 284, 286, 287, 288]"
koa,29067,771,750,21,"[1, 2, 3, 4, 5, 6, 7, 8, 9, 10, 11, 12, 13, 14, 15, 16, 17, 18, 20, 21, 26, 27, 30, 31, 32, 33, 34, 35, 38, 39, 40, 41, 42, 45, 47, 48, 49, 50, 52, 54, 57, 62, 63, 64, 66, 68, 69, 70, 71, 72, 73, 75, 76, 78, 79, 80, 82, 84, 91, 92, 94, 95, 96, 97, 98, 99, 100, 101, 102, 103, 104, 105, 106, 107, 108, 111, 114, 115, 116, 117, 120, 124, 128, 130, 134, 138, 140, 142, 144, 146, 148, 150, 151, 152, 153, 156, 157, 161, 164, 165]"
fzf,29008,1577,1426,151,"[1, 2, 3, 7, 8, 9, 10, 11, 12, 13, 14, 15, 16, 18, 21, 22, 23, 24, 27, 31, 33, 34, 36, 38, 39, 40, 41, 42, 43, 48, 49, 50, 51, 52, 53, 54, 58, 59, 60, 61, 62, 64, 65, 68, 70, 72, 73, 74, 76, 77, 78, 79, 81, 82, 83, 84, 85, 86, 87, 88, 89, 90, 91, 93, 94, 96, 98, 99, 100, 101, 102, 103, 105, 107, 108, 110, 111, 112, 118, 119, 120, 121, 124, 125, 126, 127, 128, 129, 130, 131, 132, 135, 137, 139, 140, 141, 142, 143, 144, 146]"
glide,28937,3698,3555,143,"[1, 2, 3, 4, 5, 6, 7, 8, 9, 10, 11, 12, 13, 14, 15, 16, 17, 18, 19, 20, 21, 22, 23, 24, 26, 27, 28, 31, 32, 33, 34, 40, 41, 42, 43, 44, 45, 46, 47, 49, 51, 52, 53, 54, 55, 56, 58, 59, 60, 62, 63, 65, 66, 67, 68, 69, 70, 71, 72, 73, 74, 76, 77, 78, 79, 80, 81, 82, 83, 84, 85, 86, 88, 89, 90, 91, 92, 93, 94, 95, 97, 104, 106, 107, 108, 109, 110, 111, 112, 113, 115, 116, 117, 118, 119, 121, 122, 123, 124, 126]"
lottie-android,28693,1124,1087,37,"[3, 4, 6, 16, 17, 27, 28, 31, 33, 34, 35, 36, 37, 39, 40, 41, 43, 44, 45, 46, 47, 51, 55, 56, 57, 58, 59, 60, 61, 62, 63, 64, 65, 66, 69, 70, 71, 72, 73, 74, 75, 77, 78, 79, 80, 84, 85, 86, 89, 90, 91, 92, 93, 94, 96, 97, 98, 99, 100, 101, 102, 103, 105, 106, 107, 108, 109, 112, 113, 116, 119, 120, 122, 123, 129, 133, 135, 138, 141, 142, 143, 147, 148, 149, 151, 153, 154, 156, 158, 159, 161, 162, 163, 165, 167, 168, 170, 171, 172, 173]"
chinese-poetry,28671,119,71,48,"[1, 2, 3, 4, 5, 6, 7, 9, 11, 12, 13, 14, 16, 17, 18, 19, 20, 21, 22, 23, 24, 25, 26, 27, 29, 30, 31, 33, 35, 36, 37, 38, 39, 40, 42, 43, 47, 49, 51, 52, 53, 54, 59, 63, 65, 67, 69, 70, 71, 75, 76, 77, 79, 80, 81, 82, 83, 84, 86, 87, 93, 97, 98, 107, 111, 112, 113, 115, 116, 118, 120, 122, 125, 128, 129, 130, 131, 133, 134, 135, 137, 139, 140, 141, 142, 148, 149, 154, 155, 159, 161, 162, 163, 165, 166, 167, 169, 170, 171, 172]"
traefik,28661,3698,3214,484,"[5, 7, 8, 9, 10, 11, 15, 17, 19, 21, 22, 25, 30, 31, 34, 35, 37, 40, 41, 44, 46, 50, 56, 58, 59, 60, 61, 64, 66, 67, 68, 69, 73, 74, 75, 77, 81, 86, 89, 95, 97, 98, 101, 102, 103, 104, 106, 107, 110, 113, 114, 115, 116, 117, 118, 119, 125, 127, 128, 130, 131, 133, 136, 139, 140, 141, 142, 143, 144, 145, 146, 147, 150, 151, 152, 154, 155, 156, 157, 158, 159, 160, 162, 163, 167, 169, 170, 173, 176, 179, 180, 181, 182, 190, 191, 192, 194, 197, 198, 199]"
fastlane,28651,10488,10327,161,"[6, 8, 9, 10, 11, 14, 17, 18, 19, 20, 22, 25, 26, 27, 30, 31, 32, 34, 35, 37, 39, 40, 41, 42, 45, 46, 47, 48, 49, 50, 52, 55, 58, 59, 62, 64, 65, 66, 67, 68, 69, 72, 73, 74, 75, 76, 79, 85, 87, 88, 89, 90, 91, 93, 101, 102, 103, 105, 106, 107, 109, 115, 116, 118, 119, 120, 123, 126, 130, 131, 138, 139, 143, 144, 146, 148, 150, 151, 153, 155, 159, 162, 163, 164, 165, 167, 169, 170, 171, 172, 174, 176, 177, 178, 180, 181, 182, 183, 187, 189]"
incubator-superset,28640,4442,4190,252,"[1, 2, 4, 5, 6, 7, 14, 17, 18, 21, 24, 44, 47, 49, 50, 54, 55, 57, 62, 78, 106, 107, 110, 114, 116, 118, 119, 137, 143, 144, 150, 152, 167, 170, 173, 174, 177, 179, 180, 183, 185, 195, 207, 208, 211, 215, 216, 217, 220, 226, 228, 230, 232, 233, 235, 236, 237, 238, 239, 240, 241, 245, 252, 253, 254, 259, 260, 261, 264, 266, 267, 268, 269, 270, 273, 274, 275, 277, 279, 280, 281, 287, 290, 291, 292, 293, 296, 299, 305, 308, 315, 316, 318, 320, 321, 322, 325, 331, 333, 334]"
foundation-sites,28607,7953,7696,257,"[1, 2, 3, 5, 6, 7, 8, 9, 10, 11, 12, 13, 14, 15, 17, 18, 19, 20, 21, 22, 23, 24, 25, 26, 27, 28, 29, 30, 32, 33, 34, 35, 36, 37, 38, 39, 40, 41, 42, 43, 44, 45, 46, 47, 48, 49, 50, 51, 52, 53, 55, 56, 57, 58, 59, 60, 61, 63, 64, 65, 67, 68, 69, 71, 72, 73, 74, 75, 76, 77, 78, 79, 80, 81, 82, 83, 84, 85, 86, 87, 88, 89, 90, 91, 92, 93, 94, 95, 96, 97, 98, 99, 100, 101, 102, 103, 104, 105, 107, 108]"
deeplearningbook-chinese,28499,175,130,45,"[1, 2, 3, 4, 5, 6, 7, 8, 9, 10, 11, 12, 13, 14, 15, 16, 17, 18, 19, 20, 21, 23, 24, 25, 26, 28, 29, 30, 32, 33, 34, 35, 36, 37, 38, 40, 41, 42, 43, 44, 45, 46, 47, 48, 49, 52, 53, 54, 55, 56, 57, 58, 59, 60, 61, 62, 63, 64, 65, 66, 67, 68, 69, 70, 71, 72, 73, 74, 75, 76, 77, 78, 79, 80, 81, 82, 83, 84, 87, 90, 92, 93, 94, 95, 97, 98, 99, 100, 102, 103, 104, 107, 109, 110, 111, 112, 113, 114, 115, 116]"
100-Days-Of-ML-Code,28498,0,0,0,[]
clipboard.js,28484,522,512,10,"[1, 2, 3, 5, 7, 10, 12, 13, 15, 17, 18, 23, 25, 26, 27, 28, 30, 35, 36, 37, 39, 41, 43, 45, 46, 49, 52, 53, 56, 58, 59, 60, 62, 64, 66, 67, 69, 70, 71, 72, 76, 77, 79, 81, 84, 87, 88, 89, 90, 91, 92, 93, 94, 96, 97, 98, 99, 100, 102, 103, 104, 105, 107, 108, 109, 110, 111, 112, 114, 115, 116, 117, 118, 119, 121, 122, 124, 126, 127, 128, 129, 132, 133, 135, 136, 137, 138, 139, 140, 141, 142, 144, 145, 146, 147, 148, 151, 152, 153, 154]"
12306,28404,625,453,172,"[1, 3, 5, 6, 7, 8, 9, 10, 11, 12, 13, 14, 15, 16, 17, 18, 19, 21, 22, 24, 25, 27, 28, 30, 31, 32, 33, 34, 35, 36, 37, 38, 39, 40, 44, 46, 47, 48, 52, 53, 54, 55, 56, 57, 58, 59, 60, 61, 62, 63, 64, 65, 67, 71, 72, 74, 76, 77, 78, 79, 80, 81, 82, 83, 84, 85, 86, 87, 90, 91, 92, 93, 94, 95, 96, 97, 98, 102, 104, 105, 106, 107, 109, 110, 111, 113, 114, 115, 116, 117, 118, 119, 121, 122, 123, 124, 126, 127, 130, 131]"
huginn,28283,1669,1298,371,"[1, 4, 5, 6, 7, 9, 10, 11, 12, 13, 15, 16, 17, 19, 21, 28, 29, 30, 31, 32, 33, 34, 38, 41, 48, 52, 53, 55, 56, 57, 59, 60, 61, 64, 66, 67, 68, 70, 72, 76, 77, 78, 80, 81, 92, 95, 99, 102, 105, 108, 110, 113, 120, 121, 123, 125, 126, 127, 128, 129, 130, 132, 133, 135, 136, 137, 138, 141, 142, 144, 145, 148, 149, 155, 157, 166, 170, 171, 174, 175, 176, 178, 180, 183, 187, 188, 189, 192, 194, 196, 199, 200, 201, 202, 209, 215, 218, 220, 222, 226]"
video.js,28176,3983,3765,218,"[1, 2, 3, 4, 5, 6, 7, 8, 9, 10, 11, 12, 13, 14, 15, 16, 17, 18, 19, 20, 21, 22, 23, 24, 25, 26, 27, 28, 29, 30, 31, 32, 33, 34, 35, 36, 37, 38, 39, 40, 41, 42, 43, 45, 46, 48, 50, 55, 61, 62, 67, 69, 70, 71, 72, 75, 76, 77, 80, 82, 83, 86, 87, 88, 89, 90, 91, 93, 94, 95, 100, 104, 105, 108, 110, 112, 113, 114, 115, 116, 117, 118, 119, 120, 121, 122, 124, 127, 129, 130, 133, 134, 135, 136, 137, 144, 145, 146, 147, 148]"
design-patterns-for-humans,28042,49,42,7,"[14, 16, 20, 25, 28, 29, 34, 35, 40, 43, 45, 47, 51, 53, 54, 56, 57, 58, 59, 60, 68, 71, 72, 74, 78, 80, 81, 82, 83, 89, 90, 91, 92, 94, 95, 97, 101, 102, 104, 105, 107, 108, 109, 110, 111, 114, 118, 121, 122]"
caddy,28032,2109,2038,71,"[3, 4, 5, 6, 7, 8, 9, 10, 11, 12, 13, 15, 16, 17, 19, 20, 21, 22, 23, 24, 25, 27, 28, 29, 30, 31, 35, 36, 38, 39, 42, 44, 45, 46, 47, 52, 53, 54, 55, 57, 59, 60, 61, 63, 64, 65, 72, 74, 79, 80, 81, 82, 87, 91, 93, 95, 97, 100, 103, 104, 106, 107, 108, 109, 110, 111, 113, 115, 119, 120, 122, 123, 124, 125, 126, 127, 132, 133, 136, 139, 140, 141, 142, 143, 144, 145, 146, 147, 148, 150, 151, 154, 158, 159, 162, 163, 164, 167, 173, 175]"
legacy-homebrew,27814,17038,17038,0,"[1, 2, 3, 4, 5, 6, 7, 8, 9, 10, 11, 12, 13, 14, 15, 16, 17, 18, 19, 20, 21, 22, 23, 24, 25, 26, 27, 28, 29, 30, 31, 32, 33, 34, 35, 36, 37, 38, 39, 40, 41, 42, 43, 44, 45, 46, 47, 48, 49, 50, 51, 52, 53, 54, 55, 56, 57, 58, 59, 60, 61, 62, 63, 64, 65, 66, 67, 68, 69, 70, 71, 72, 73, 74, 75, 76, 77, 78, 79, 80, 81, 82, 83, 84, 85, 86, 87, 88, 89, 90, 91, 92, 93, 94, 95, 96, 97, 98, 99, 100]"
DefinitelyTyped,27814,6502,3272,3230,"[2, 5, 7, 8, 9, 10, 11, 12, 13, 16, 18, 20, 21, 24, 25, 33, 35, 36, 37, 38, 40, 42, 43, 45, 48, 51, 52, 53, 55, 57, 58, 61, 63, 64, 68, 70, 72, 73, 77, 79, 83, 84, 85, 86, 87, 88, 89, 95, 96, 98, 106, 112, 115, 116, 118, 120, 124, 125, 127, 130, 136, 139, 143, 151, 152, 157, 162, 163, 166, 169, 173, 174, 182, 184, 185, 193, 194, 200, 207, 208, 218, 224, 225, 228, 231, 241, 244, 248, 251, 255, 256, 257, 260, 261, 264, 265, 272, 277, 282, 287]"
Leaflet,27777,4270,3877,393,"[1, 2, 3, 4, 5, 6, 7, 8, 9, 10, 11, 12, 13, 14, 15, 16, 17, 18, 19, 20, 21, 22, 23, 24, 25, 26, 27, 30, 31, 32, 33, 34, 36, 37, 38, 39, 40, 41, 42, 43, 44, 45, 46, 47, 48, 49, 50, 51, 52, 53, 54, 55, 56, 57, 58, 59, 60, 61, 62, 63, 64, 65, 66, 67, 68, 69, 70, 72, 73, 74, 75, 76, 77, 78, 80, 82, 83, 84, 85, 86, 87, 88, 90, 91, 92, 93, 94, 96, 97, 99, 100, 101, 102, 103, 104, 105, 106, 107, 108, 109]"
ShadowsocksX-NG,27673,1187,982,205,"[1, 4, 5, 6, 7, 9, 10, 11, 12, 15, 16, 17, 18, 19, 20, 22, 23, 24, 25, 26, 27, 28, 29, 30, 31, 32, 33, 34, 35, 38, 39, 40, 42, 46, 47, 48, 49, 50, 51, 52, 55, 56, 57, 59, 60, 61, 62, 63, 64, 65, 66, 67, 68, 69, 70, 71, 72, 74, 76, 77, 79, 80, 81, 82, 83, 86, 88, 89, 90, 91, 93, 94, 96, 98, 99, 101, 102, 103, 104, 105, 106, 107, 108, 109, 110, 111, 112, 113, 115, 117, 118, 119, 120, 121, 122, 123, 124, 125, 126, 127]"
backbone,27643,2384,2329,55,"[1, 2, 3, 4, 7, 8, 9, 10, 14, 15, 16, 17, 21, 22, 24, 26, 27, 28, 32, 33, 35, 36, 37, 38, 39, 40, 41, 42, 44, 45, 51, 55, 56, 57, 58, 60, 61, 62, 64, 65, 66, 67, 69, 71, 72, 73, 75, 76, 77, 78, 79, 80, 81, 82, 83, 84, 85, 88, 90, 91, 93, 94, 96, 97, 98, 99, 101, 102, 103, 104, 105, 106, 107, 108, 109, 111, 112, 113, 117, 118, 119, 120, 121, 124, 125, 126, 127, 128, 129, 130, 132, 133, 134, 136, 137, 138, 139, 140, 141, 143]"
awesome-flutter,27578,0,0,0,[]
phantomjs,27541,4706,4676,30,"[11140, 11141, 11142, 10001, 10002, 10003, 10004, 10005, 10006, 10007, 10008, 10009, 10010, 10011, 10012, 10013, 10014, 10015, 10016, 10017, 10018, 10019, 10020, 10021, 10022, 10023, 10024, 10025, 10026, 10027, 10028, 10029, 10030, 10031, 10032, 10033, 10034, 10035, 10036, 10037, 10038, 10039, 10040, 10041, 10042, 10043, 10044, 10045, 10046, 10047, 10048, 10049, 10050, 10051, 10052, 10053, 10054, 10055, 10056, 10057, 10058, 10059, 10060, 10061, 10062, 10063, 10064, 10065, 10066, 10067, 10068, 10069, 10070, 10071, 10072, 10073, 10074, 10075, 10076, 10077, 10078, 10079, 10080, 10081, 10082, 10083, 10084, 10085, 10086, 10087, 10088, 10089, 10090, 10091, 10092, 10093, 10094, 10095, 10096, 10097]"
es6features,27538,55,36,19,"[2, 3, 4, 6, 7, 15, 16, 17, 19, 20, 26, 27, 28, 34, 36, 37, 38, 39, 41, 43, 46, 49, 50, 53, 54, 63, 64, 67, 68, 69, 70, 72, 75, 80, 83, 84, 86, 88, 90, 93, 94, 96, 100, 101, 102, 104, 105, 107, 108, 111, 115, 117, 119, 125, 130]"
phaser,27198,3247,3061,186,"[1, 2, 3, 4, 5, 6, 7, 8, 10, 12, 13, 14, 15, 16, 18, 21, 23, 24, 25, 26, 27, 28, 29, 30, 31, 32, 33, 34, 36, 37, 38, 40, 42, 44, 45, 47, 48, 50, 51, 53, 55, 57, 58, 59, 64, 65, 68, 69, 70, 73, 81, 82, 86, 88, 89, 91, 92, 94, 95, 96, 97, 98, 100, 101, 105, 106, 107, 109, 111, 112, 114, 116, 117, 118, 127, 131, 132, 133, 135, 136, 138, 140, 141, 142, 143, 145, 146, 148, 149, 151, 152, 153, 154, 156, 157, 161, 165, 168, 171, 177]"
php-src,27148,0,0,0,[]
frontend-dev-bookmarks,27106,93,77,16,"[17, 18, 31, 41, 43, 47, 56, 71, 72, 92, 95, 97, 99, 102, 103, 117, 118, 119, 124, 125, 126, 129, 130, 131, 132, 133, 134, 135, 136, 139, 140, 149, 161, 178, 179, 187, 188, 189, 196, 207, 209, 214, 220, 221, 222, 223, 225, 227, 231, 232, 233, 235, 236, 238, 240, 241, 243, 244, 245, 246, 247, 267, 269, 271, 274, 278, 289, 292, 295, 296, 298, 308, 309, 312, 313, 314, 318, 322, 337, 341, 349, 355, 356, 358, 363, 364, 369, 371, 372, 386, 393, 410, 411]"
CppCoreGuidelines,27104,799,637,162,"[1, 2, 9, 11, 15, 19, 23, 24, 26, 27, 28, 29, 30, 33, 34, 35, 40, 47, 49, 51, 53, 59, 61, 66, 68, 70, 71, 83, 88, 90, 95, 101, 103, 106, 108, 109, 116, 122, 123, 125, 128, 131, 133, 134, 135, 136, 141, 142, 143, 144, 146, 150, 154, 156, 159, 167, 169, 170, 176, 177, 179, 180, 181, 182, 183, 186, 187, 189, 190, 192, 193, 195, 200, 202, 204, 205, 222, 224, 225, 226, 227, 231, 233, 235, 239, 241, 243, 245, 246, 248, 249, 251, 252, 259, 267, 270, 271, 272, 282, 284]"
awesome-react-native,27096,51,33,18,"[8, 19, 26, 27, 36, 43, 63, 74, 84, 88, 89, 93, 112, 123, 136, 178, 202, 228, 286, 291, 304, 332, 361, 387, 400, 413, 439, 453, 489, 538, 544, 546, 571, 599, 618, 637, 638, 675, 691, 697, 701, 729, 763, 783, 808, 889, 900, 916, 925, 983, 989]"
HEAD,27060,82,71,11,"[4, 5, 6, 11, 12, 13, 14, 15, 16, 17, 18, 19, 20, 26, 27, 29, 31, 35, 41, 42, 44, 45, 46, 50, 51, 52, 53, 56, 57, 59, 61, 73, 78, 79, 81, 89, 90, 91, 93, 94, 97, 98, 104, 106, 107, 115, 121, 122, 123, 126, 128, 129, 130, 135, 140, 141, 148, 149, 153, 154, 158, 165, 166, 170, 174, 179, 181, 185, 186, 190, 191, 192, 193, 195, 198, 201, 204, 207, 214, 216, 232, 250]"
dayjs,27016,391,335,56,"[1, 32, 36, 38, 39, 40, 41, 45, 46, 49, 50, 56, 58, 60, 61, 63, 67, 70, 71, 73, 80, 82, 87, 88, 93, 96, 97, 103, 104, 105, 111, 112, 113, 115, 116, 118, 122, 124, 126, 127, 129, 134, 135, 136, 137, 138, 139, 142, 143, 146, 152, 154, 164, 171, 172, 175, 181, 185, 188, 197, 204, 209, 215, 223, 234, 235, 236, 239, 240, 241, 242, 244, 246, 248, 249, 251, 252, 253, 254, 255, 257, 261, 262, 263, 265, 268, 269, 271, 273, 274, 277, 279, 280, 281, 282, 284, 285, 286, 287, 288]"
nuxt.js,26929,5094,4798,296,"[1, 2, 4, 6, 9, 10, 11, 12, 13, 14, 16, 17, 18, 19, 20, 21, 22, 23, 24, 25, 26, 27, 28, 29, 30, 31, 32, 33, 34, 35, 36, 37, 38, 41, 42, 43, 45, 46, 52, 53, 54, 55, 57, 58, 59, 60, 61, 63, 64, 66, 67, 68, 69, 70, 71, 72, 73, 74, 75, 76, 78, 80, 81, 82, 83, 84, 85, 86, 87, 88, 89, 91, 93, 94, 95, 96, 97, 98, 99, 100, 101, 102, 103, 105, 106, 107, 108, 109, 110, 111, 112, 113, 114, 115, 116, 117, 119, 120, 121, 122]"
AndroidUtilCode,26903,1059,1051,8,"[1, 2, 3, 4, 5, 6, 7, 8, 11, 15, 16, 19, 22, 23, 24, 29, 30, 32, 33, 34, 36, 37, 38, 40, 41, 42, 43, 45, 47, 50, 54, 55, 57, 58, 59, 60, 66, 67, 68, 69, 70, 71, 72, 73, 74, 75, 76, 77, 78, 79, 80, 81, 82, 83, 84, 86, 87, 88, 89, 90, 92, 93, 94, 95, 96, 97, 99, 100, 101, 102, 103, 104, 105, 106, 107, 108, 109, 111, 117, 118, 119, 120, 121, 123, 124, 125, 126, 127, 128, 129, 130, 131, 133, 134, 135, 136, 137, 138, 139, 141]"
tldr,26866,511,441,70,"[4, 7, 8, 9, 10, 11, 12, 13, 14, 15, 16, 17, 21, 22, 23, 26, 33, 34, 35, 36, 37, 46, 56, 59, 61, 62, 77, 78, 90, 91, 96, 103, 104, 107, 121, 131, 147, 151, 164, 166, 168, 188, 190, 209, 233, 256, 261, 263, 264, 266, 270, 273, 278, 300, 307, 310, 314, 319, 323, 336, 340, 343, 344, 351, 352, 355, 376, 380, 384, 388, 390, 392, 393, 399, 419, 428, 440, 459, 468, 478, 481, 484, 487, 488, 496, 497, 523, 527, 539, 542, 558, 569, 574, 622, 624, 646, 647, 667, 686, 687]"
julia,26816,17686,14815,2871,"[1, 2, 3, 4, 5, 6, 7, 8, 9, 10, 11, 12, 13, 14, 15, 16, 17, 18, 19, 20, 21, 22, 23, 24, 25, 26, 27, 28, 29, 30, 31, 32, 33, 34, 35, 36, 37, 38, 39, 40, 41, 42, 43, 44, 45, 46, 47, 48, 49, 50, 51, 52, 53, 54, 55, 56, 57, 58, 59, 60, 61, 62, 63, 64, 65, 66, 67, 68, 69, 70, 71, 72, 73, 74, 75, 76, 77, 78, 79, 80, 81, 82, 83, 84, 85, 86, 87, 88, 89, 90, 91, 92, 93, 94, 95, 96, 97, 98, 99, 100]"
certbot,26658,4362,3849,513,"[3, 5, 6, 8, 10, 15, 16, 20, 21, 24, 27, 28, 31, 32, 34, 35, 36, 37, 38, 41, 42, 43, 44, 47, 53, 55, 58, 59, 61, 62, 63, 65, 66, 68, 70, 80, 83, 86, 91, 94, 97, 107, 108, 115, 116, 120, 123, 136, 137, 139, 142, 147, 149, 150, 151, 152, 155, 156, 164, 166, 168, 169, 172, 173, 178, 179, 180, 181, 182, 187, 191, 194, 195, 198, 199, 200, 201, 202, 204, 209, 210, 211, 214, 221, 224, 225, 228, 229, 230, 231, 235, 245, 246, 253, 255, 256, 257, 258, 259, 260]"
android_guides,26631,362,211,151,"[1, 2, 3, 4, 5, 6, 7, 8, 9, 10, 11, 12, 13, 14, 15, 16, 17, 18, 19, 20, 21, 22, 23, 24, 25, 26, 27, 28, 29, 30, 31, 32, 33, 34, 35, 36, 37, 38, 39, 40, 41, 42, 43, 44, 45, 46, 47, 48, 49, 50, 51, 52, 53, 54, 55, 56, 57, 58, 59, 60, 61, 62, 63, 64, 65, 66, 67, 68, 69, 70, 71, 72, 73, 74, 75, 76, 77, 78, 79, 80, 81, 82, 84, 85, 86, 87, 89, 90, 91, 92, 93, 95, 96, 97, 98, 99, 100, 101, 102, 103]"
nest,26621,2553,2481,72,"[1, 2, 3, 4, 6, 7, 11, 12, 13, 14, 15, 16, 17, 18, 20, 21, 23, 24, 25, 28, 29, 30, 31, 34, 35, 36, 37, 38, 39, 40, 41, 42, 43, 44, 45, 47, 48, 50, 51, 52, 53, 54, 55, 57, 59, 61, 63, 65, 66, 67, 68, 69, 70, 71, 72, 73, 74, 75, 76, 77, 79, 81, 82, 83, 84, 85, 86, 87, 88, 89, 90, 91, 92, 93, 94, 95, 97, 99, 101, 102, 103, 105, 106, 107, 108, 109, 110, 112, 113, 114, 115, 116, 117, 118, 119, 121, 122, 124, 125, 126]"
Rocket.Chat,26554,10649,8464,2185,"[3, 4, 6, 7, 11, 12, 13, 14, 15, 16, 17, 18, 19, 20, 21, 22, 23, 24, 25, 26, 27, 28, 29, 30, 31, 32, 33, 34, 35, 36, 37, 38, 39, 42, 43, 44, 45, 46, 47, 49, 50, 51, 53, 55, 56, 57, 58, 59, 60, 61, 62, 63, 64, 65, 66, 67, 68, 69, 70, 71, 72, 73, 74, 75, 76, 77, 78, 79, 80, 81, 82, 87, 88, 89, 90, 94, 96, 97, 99, 100, 101, 102, 103, 104, 105, 108, 109, 114, 115, 116, 117, 119, 122, 123, 125, 126, 127, 128, 129, 130]"
todomvc,26536,734,618,116,"[1, 2, 4, 5, 7, 10, 11, 13, 14, 17, 21, 22, 24, 28, 32, 35, 36, 40, 45, 58, 60, 61, 62, 63, 64, 65, 66, 67, 68, 69, 70, 71, 72, 73, 74, 76, 77, 79, 81, 83, 84, 86, 87, 89, 90, 91, 94, 95, 101, 107, 110, 121, 125, 128, 130, 131, 134, 137, 138, 141, 153, 154, 155, 159, 160, 174, 179, 180, 183, 189, 199, 200, 203, 204, 207, 211, 215, 216, 217, 220, 223, 224, 227, 229, 230, 236, 237, 240, 249, 250, 253, 254, 255, 257, 259, 262, 267, 268, 270, 279]"
async,26513,1047,1045,2,"[1, 2, 3, 4, 5, 6, 7, 8, 9, 10, 11, 13, 14, 15, 17, 18, 19, 20, 22, 26, 27, 28, 29, 31, 34, 35, 36, 37, 40, 42, 43, 45, 46, 49, 51, 52, 54, 55, 56, 58, 59, 62, 64, 66, 67, 69, 70, 71, 72, 74, 75, 76, 78, 87, 88, 94, 96, 97, 98, 104, 105, 106, 108, 110, 112, 114, 116, 118, 119, 122, 125, 127, 128, 129, 130, 132, 139, 140, 142, 143, 144, 145, 147, 151, 152, 153, 154, 155, 156, 160, 161, 162, 163, 165, 166, 167, 169, 170, 173, 174]"
ijkplayer,26370,4826,2411,2415,"[3, 4, 5, 6, 7, 8, 9, 10, 11, 12, 13, 14, 15, 16, 17, 18, 19, 20, 21, 22, 23, 24, 25, 26, 27, 28, 29, 30, 31, 33, 34, 35, 36, 37, 38, 39, 40, 41, 42, 43, 44, 45, 46, 47, 48, 49, 50, 51, 52, 53, 54, 55, 56, 57, 59, 60, 61, 62, 63, 64, 65, 66, 67, 68, 69, 70, 71, 72, 75, 76, 77, 78, 79, 80, 81, 82, 83, 84, 85, 86, 88, 89, 90, 91, 92, 93, 94, 95, 96, 97, 98, 99, 100, 101, 102, 103, 104, 105, 106, 107]"
quill,26329,2580,1807,773,"[1, 2, 3, 4, 5, 6, 7, 8, 9, 10, 11, 12, 13, 14, 15, 16, 17, 18, 19, 20, 21, 22, 23, 24, 25, 26, 27, 28, 29, 30, 31, 32, 33, 34, 35, 36, 37, 38, 39, 40, 41, 42, 43, 44, 45, 46, 47, 48, 49, 50, 51, 52, 53, 54, 55, 56, 57, 58, 59, 60, 61, 62, 63, 64, 65, 67, 68, 69, 71, 73, 74, 76, 77, 79, 80, 81, 82, 83, 84, 85, 87, 88, 89, 90, 91, 93, 94, 95, 98, 100, 101, 102, 103, 104, 105, 106, 107, 109, 110, 111]"
interview_internal_reference,26297,34,18,16,"[1, 3, 5, 6, 8, 9, 12, 13, 14, 15, 17, 18, 19, 21, 24, 25, 28, 29, 31, 32, 33, 41, 43, 44, 52, 58, 60, 62, 64, 67, 74, 75, 76, 78]"
transformers,26199,2839,2400,439,"[3, 5, 6, 9, 10, 11, 12, 13, 15, 19, 20, 23, 24, 25, 26, 27, 28, 30, 31, 33, 34, 35, 36, 37, 38, 39, 41, 43, 44, 45, 46, 47, 48, 49, 50, 51, 52, 53, 54, 55, 56, 57, 59, 61, 62, 63, 64, 65, 67, 68, 69, 71, 76, 78, 79, 80, 81, 82, 83, 85, 86, 88, 89, 90, 92, 95, 97, 98, 99, 100, 102, 103, 104, 105, 106, 108, 109, 110, 114, 115, 117, 118, 120, 121, 122, 123, 125, 126, 129, 131, 132, 133, 135, 136, 137, 138, 139, 140, 143, 144]"
preact,26147,1177,1075,102,"[2, 3, 5, 7, 8, 10, 11, 17, 23, 24, 25, 28, 29, 30, 31, 32, 33, 34, 36, 38, 39, 44, 45, 46, 47, 49, 50, 51, 52, 53, 54, 56, 58, 59, 60, 65, 72, 73, 76, 79, 81, 82, 83, 84, 87, 88, 89, 90, 92, 93, 94, 96, 97, 98, 103, 104, 114, 115, 120, 122, 123, 125, 126, 129, 131, 135, 138, 140, 141, 143, 146, 148, 149, 154, 155, 156, 158, 159, 162, 163, 164, 166, 168, 172, 173, 174, 175, 176, 177, 178, 181, 182, 187, 190, 193, 194, 195, 203, 204, 207]"
gold-miner,26122,4357,4321,36,"[1, 2, 3, 4, 5, 6, 7, 8, 9, 10, 11, 12, 13, 14, 15, 16, 17, 18, 19, 20, 21, 22, 23, 24, 25, 26, 27, 28, 29, 31, 32, 33, 34, 35, 36, 37, 39, 40, 41, 42, 43, 44, 45, 46, 47, 50, 52, 54, 55, 57, 58, 59, 60, 63, 64, 65, 67, 68, 69, 70, 72, 73, 75, 81, 84, 88, 90, 94, 102, 104, 105, 108, 109, 110, 111, 112, 113, 114, 117, 118, 121, 125, 126, 127, 128, 131, 132, 133, 134, 136, 138, 140, 141, 143, 144, 146, 149, 150, 151, 152]"
og-aws,26114,199,79,120,"[1, 2, 3, 4, 5, 6, 7, 8, 9, 10, 11, 12, 13, 14, 15, 16, 17, 18, 21, 23, 25, 26, 27, 28, 30, 32, 33, 34, 35, 36, 39, 42, 43, 44, 46, 49, 50, 51, 52, 53, 54, 55, 57, 58, 59, 60, 61, 63, 64, 65, 67, 68, 69, 70, 74, 76, 77, 86, 91, 92, 94, 98, 104, 107, 118, 119, 123, 127, 130, 148, 150, 160, 161, 168, 175, 179, 194, 195, 201, 212, 215, 216, 221, 230, 232, 238, 243, 256, 257, 258, 259, 262, 264, 269, 270, 274, 285, 290, 291, 293]"
Deep-Learning-Papers-Reading-Roadmap,26103,41,3,38,"[3, 6, 10, 11, 12, 14, 19, 27, 28, 30, 31, 33, 44, 45, 46, 50, 52, 58, 60, 62, 63, 67, 69, 74, 77, 80, 81, 82, 83, 85, 88, 90, 95, 96, 102, 103, 104, 109, 112, 113, 117]"
awesome-awesomeness,25993,55,49,6,"[3, 6, 18, 23, 27, 41, 52, 64, 67, 117, 127, 153, 155, 160, 169, 172, 179, 186, 194, 197, 198, 203, 208, 220, 225, 229, 230, 235, 236, 239, 240, 241, 248, 256, 263, 267, 270, 271, 279, 282, 283, 287, 288, 298, 320, 322, 334, 337, 339, 346, 350, 352, 395, 405, 408]"
what-happens-when,25986,100,18,82,"[3, 9, 10, 11, 14, 15, 16, 19, 27, 29, 30, 32, 34, 35, 39, 43, 44, 45, 49, 50, 55, 74, 75, 79, 87, 88, 89, 90, 94, 97, 98, 99, 100, 102, 103, 105, 107, 110, 111, 112, 113, 117, 120, 122, 124, 126, 127, 129, 130, 131, 132, 141, 156, 159, 160, 173, 176, 179, 181, 184, 194, 196, 197, 198, 199, 203, 204, 207, 210, 211, 221, 222, 225, 228, 229, 231, 233, 241, 242, 246, 250, 253, 254, 255, 258, 260, 261, 262, 263, 267, 268, 269, 271, 274, 282, 283, 286, 287, 288, 289]"
spark,25962,0,0,0,[]
grpc,25914,8487,7965,522,"[10, 20, 31, 38, 41, 42, 43, 44, 49, 50, 51, 52, 53, 54, 55, 56, 57, 58, 59, 60, 61, 63, 64, 67, 71, 73, 75, 76, 84, 90, 101, 112, 113, 114, 115, 116, 117, 118, 119, 120, 121, 122, 123, 124, 125, 126, 127, 128, 129, 130, 131, 132, 133, 134, 135, 136, 137, 140, 144, 147, 148, 156, 159, 161, 162, 163, 170, 176, 177, 180, 181, 183, 186, 192, 194, 195, 199, 200, 201, 202, 203, 205, 206, 214, 215, 216, 217, 218, 219, 222, 223, 229, 231, 232, 238, 239, 241, 242, 243, 246]"
awesome-scalability,25843,0,0,0,[]
go-ethereum,25841,4825,4563,262,"[1, 5, 6, 7, 8, 12, 13, 14, 15, 16, 17, 18, 20, 22, 26, 29, 30, 35, 36, 37, 38, 39, 40, 41, 42, 43, 44, 45, 46, 47, 48, 49, 50, 51, 52, 53, 54, 55, 56, 57, 58, 59, 60, 61, 62, 63, 64, 65, 66, 67, 68, 69, 70, 71, 72, 73, 74, 75, 76, 77, 78, 79, 80, 81, 83, 85, 86, 87, 88, 89, 90, 91, 93, 95, 97, 99, 102, 103, 105, 106, 107, 108, 110, 111, 117, 118, 119, 120, 125, 126, 127, 128, 130, 131, 132, 133, 134, 135, 143, 144]"
kong,25645,2930,2614,316,"[1, 2, 3, 4, 5, 6, 7, 8, 9, 10, 11, 12, 15, 16, 17, 18, 20, 21, 23, 24, 25, 29, 33, 35, 36, 38, 43, 46, 48, 50, 51, 52, 55, 56, 57, 58, 59, 65, 67, 68, 70, 71, 73, 77, 78, 80, 81, 83, 86, 87, 91, 92, 93, 94, 95, 96, 97, 98, 103, 104, 107, 109, 111, 112, 113, 115, 116, 117, 118, 119, 120, 121, 122, 123, 124, 125, 126, 127, 128, 132, 133, 134, 135, 136, 139, 148, 149, 150, 151, 153, 154, 155, 157, 160, 161, 163, 164, 167, 168, 169]"
proxyee-down,25614,0,0,0,[]
slick,25479,3309,2318,991,"[1, 2, 5, 6, 7, 8, 9, 10, 11, 12, 13, 15, 16, 18, 19, 21, 22, 23, 25, 28, 29, 30, 31, 32, 35, 37, 38, 39, 40, 42, 43, 44, 45, 46, 47, 48, 49, 50, 51, 52, 54, 55, 56, 57, 58, 59, 60, 61, 62, 63, 64, 65, 67, 68, 69, 70, 71, 73, 74, 75, 77, 78, 79, 80, 81, 82, 83, 87, 88, 89, 91, 95, 96, 98, 102, 103, 104, 106, 107, 108, 109, 110, 111, 113, 115, 116, 117, 118, 120, 122, 124, 125, 126, 127, 128, 129, 130, 132, 133, 134]"
awesome-cpp,25362,449,149,300,"[4, 11, 12, 13, 23, 46, 51, 52, 55, 56, 57, 58, 64, 68, 72, 73, 74, 82, 86, 92, 111, 115, 128, 130, 137, 149, 160, 164, 166, 171, 175, 181, 183, 184, 185, 192, 194, 197, 206, 208, 209, 212, 220, 225, 226, 228, 229, 231, 238, 239, 244, 246, 247, 249, 250, 252, 255, 258, 262, 267, 269, 271, 273, 275, 276, 288, 289, 293, 294, 295, 300, 302, 303, 309, 313, 314, 315, 316, 317, 318, 319, 320, 321, 322, 323, 324, 325, 327, 331, 332, 334, 335, 336, 337, 338, 339, 341, 342, 343, 345]"
react-boilerplate,25338,1785,1757,28,"[1, 2, 3, 4, 5, 6, 7, 8, 9, 10, 11, 12, 13, 14, 15, 16, 17, 18, 19, 20, 21, 22, 23, 24, 25, 26, 27, 29, 30, 31, 32, 33, 35, 36, 38, 39, 44, 45, 46, 49, 50, 55, 56, 57, 65, 67, 68, 69, 70, 71, 72, 74, 75, 76, 77, 78, 79, 80, 81, 84, 86, 87, 89, 90, 91, 92, 94, 95, 96, 100, 102, 107, 108, 109, 113, 114, 115, 116, 119, 120, 121, 122, 123, 125, 126, 127, 128, 129, 130, 132, 134, 135, 137, 138, 139, 141, 142, 143, 144, 145]"
underscore,25308,1355,1306,49,"[1, 2, 3, 4, 5, 6, 7, 8, 9, 10, 11, 12, 13, 14, 15, 16, 17, 18, 19, 21, 22, 23, 24, 25, 26, 27, 28, 29, 30, 31, 32, 33, 35, 37, 38, 40, 43, 47, 50, 55, 56, 60, 61, 62, 64, 65, 66, 68, 69, 70, 71, 72, 73, 77, 79, 81, 82, 83, 84, 85, 86, 88, 90, 91, 92, 93, 94, 95, 96, 97, 100, 103, 104, 105, 106, 107, 110, 111, 114, 115, 116, 118, 119, 123, 124, 125, 127, 128, 129, 131, 132, 136, 137, 138, 142, 143, 145, 146, 147, 148]"
butterknife,25256,1119,1027,92,"[1, 2, 4, 6, 7, 8, 10, 11, 12, 14, 15, 16, 17, 18, 20, 21, 22, 23, 24, 25, 27, 28, 29, 30, 31, 33, 34, 39, 41, 43, 44, 45, 49, 50, 53, 54, 55, 56, 57, 58, 62, 63, 64, 65, 66, 67, 70, 73, 74, 76, 77, 79, 81, 83, 85, 86, 87, 88, 89, 90, 91, 92, 93, 94, 95, 96, 97, 99, 100, 101, 102, 103, 104, 105, 107, 109, 110, 111, 112, 113, 115, 116, 118, 123, 124, 125, 126, 127, 128, 129, 130, 131, 132, 134, 135, 137, 138, 139, 141, 142]"
zxing,25250,994,986,8,"[21, 22, 23, 24, 25, 26, 27, 28, 29, 30, 31, 32, 33, 34, 35, 36, 37, 41, 44, 45, 46, 47, 48, 49, 53, 54, 55, 56, 57, 58, 59, 60, 62, 64, 65, 66, 67, 68, 69, 71, 72, 73, 75, 77, 78, 80, 81, 82, 83, 84, 85, 86, 88, 89, 90, 91, 92, 93, 94, 95, 96, 97, 98, 99, 100, 103, 104, 105, 106, 107, 108, 109, 110, 111, 115, 116, 117, 118, 119, 120, 121, 122, 123, 124, 125, 126, 127, 130, 131, 132, 133, 134, 137, 138, 139, 140, 142, 143, 144, 145]"
vuetify,25193,8324,7269,1055,"[1, 2, 3, 4, 5, 6, 7, 8, 9, 10, 11, 12, 14, 15, 16, 17, 18, 19, 21, 22, 23, 26, 27, 28, 29, 30, 31, 32, 33, 34, 35, 36, 37, 38, 39, 40, 41, 42, 43, 44, 45, 48, 49, 50, 51, 52, 53, 54, 56, 57, 58, 59, 60, 61, 62, 63, 64, 65, 66, 67, 68, 69, 70, 71, 72, 73, 74, 75, 76, 77, 78, 79, 80, 81, 82, 83, 84, 85, 86, 87, 88, 89, 90, 91, 92, 93, 94, 95, 96, 97, 98, 99, 100, 101, 102, 103, 105, 106, 108, 109]"
vue-cli,25184,4211,3735,476,"[1, 4, 5, 6, 7, 8, 9, 10, 11, 12, 13, 15, 16, 19, 20, 21, 22, 23, 24, 25, 26, 27, 28, 29, 30, 31, 32, 33, 34, 35, 36, 37, 38, 39, 40, 42, 43, 44, 45, 47, 48, 49, 50, 51, 52, 53, 54, 55, 56, 57, 58, 59, 60, 61, 62, 63, 64, 66, 69, 70, 72, 74, 75, 77, 78, 79, 80, 81, 83, 84, 86, 88, 89, 90, 91, 92, 93, 96, 97, 98, 99, 100, 101, 102, 103, 105, 106, 107, 108, 110, 111, 112, 113, 114, 115, 117, 118, 119, 121, 122]"
taro,25153,5139,4291,848,"[6, 8, 9, 10, 11, 12, 13, 14, 15, 16, 18, 19, 20, 21, 22, 23, 24, 25, 26, 27, 29, 30, 31, 32, 33, 34, 37, 38, 40, 41, 42, 44, 45, 46, 48, 50, 51, 53, 54, 55, 56, 57, 58, 59, 60, 61, 63, 64, 65, 66, 67, 68, 69, 70, 71, 72, 73, 74, 75, 76, 78, 79, 80, 81, 82, 83, 84, 85, 86, 89, 90, 91, 92, 93, 94, 95, 97, 98, 99, 100, 101, 103, 105, 106, 107, 108, 109, 110, 111, 112, 113, 114, 116, 117, 118, 119, 120, 121, 122, 123]"
programmer-job-blacklist,25053,289,168,121,"[1, 2, 3, 4, 6, 7, 8, 10, 11, 13, 14, 16, 17, 18, 19, 20, 21, 22, 23, 24, 25, 26, 27, 28, 29, 30, 31, 32, 33, 34, 35, 36, 38, 39, 40, 41, 42, 43, 45, 46, 47, 49, 51, 52, 55, 57, 58, 59, 60, 61, 64, 66, 67, 68, 69, 70, 71, 72, 73, 74, 75, 76, 77, 79, 81, 82, 83, 84, 85, 87, 88, 89, 90, 91, 93, 94, 95, 96, 97, 98, 99, 100, 102, 103, 104, 108, 109, 110, 111, 112, 113, 114, 116, 117, 118, 119, 121, 122, 123, 124]"
500lines,24890,61,36,25,"[52, 54, 55, 56, 57, 70, 84, 90, 91, 115, 134, 136, 137, 141, 153, 158, 159, 163, 165, 166, 168, 170, 178, 181, 184, 189, 197, 198, 202, 203, 204, 207, 212, 213, 215, 217, 218, 221, 227, 228, 235, 238, 239, 240, 243, 246, 247, 251, 254, 256, 257, 260, 264, 265, 267, 268, 270, 271, 273, 277, 280]"
ant-design-pro,24842,5352,5286,66,"[1, 3, 4, 5, 6, 7, 9, 11, 12, 14, 15, 16, 19, 20, 29, 30, 31, 32, 33, 34, 35, 36, 38, 40, 41, 43, 45, 46, 47, 48, 50, 51, 52, 54, 55, 56, 57, 58, 59, 60, 61, 62, 63, 64, 65, 66, 67, 68, 70, 71, 72, 73, 75, 76, 77, 78, 79, 80, 81, 82, 83, 84, 85, 87, 88, 90, 92, 93, 94, 95, 96, 97, 98, 99, 100, 101, 102, 103, 104, 105, 107, 108, 109, 110, 111, 112, 113, 114, 115, 116, 117, 118, 119, 120, 122, 124, 126, 128, 129, 130]"
sentry,24777,4016,3100,916,"[2, 3, 4, 8, 13, 14, 15, 16, 18, 19, 20, 21, 22, 24, 26, 27, 28, 29, 30, 32, 34, 35, 36, 37, 38, 39, 40, 41, 42, 44, 45, 46, 49, 50, 51, 52, 53, 54, 56, 58, 60, 63, 64, 66, 67, 68, 69, 70, 71, 73, 74, 75, 76, 77, 79, 81, 82, 83, 84, 85, 87, 88, 92, 93, 94, 96, 99, 100, 102, 103, 107, 108, 109, 111, 113, 114, 115, 116, 117, 119, 120, 123, 126, 127, 129, 131, 134, 135, 136, 137, 138, 139, 140, 141, 142, 144, 147, 149, 150, 152]"
pandas,24748,17884,14508,3376,"[1, 2, 3, 4, 5, 6, 7, 8, 9, 10, 11, 12, 13, 14, 15, 16, 17, 18, 19, 20, 21, 22, 23, 24, 25, 26, 27, 28, 29, 30, 31, 32, 33, 34, 36, 39, 40, 41, 42, 43, 44, 45, 46, 47, 48, 49, 50, 51, 52, 53, 54, 56, 57, 58, 59, 60, 61, 62, 63, 64, 65, 66, 67, 68, 69, 70, 71, 72, 73, 74, 75, 76, 77, 78, 79, 80, 81, 82, 83, 84, 85, 86, 87, 88, 90, 91, 92, 93, 94, 95, 96, 97, 98, 99, 100, 101, 102, 103, 104, 106]"
AiLearning,24665,86,55,31,"[8, 143, 175, 183, 187, 212, 252, 256, 262, 272, 326, 347, 351, 352, 363, 366, 373, 377, 378, 382, 383, 393, 396, 409, 410, 420, 421, 424, 425, 426, 427, 428, 429, 430, 431, 432, 433, 434, 435, 436, 437, 438, 439, 440, 441, 442, 443, 447, 450, 466, 468, 472, 477, 479, 480, 484, 486, 494, 498, 499, 501, 504, 512, 525, 526, 527, 532, 534, 535, 536, 539, 540, 542, 545, 552, 553, 564, 565, 566, 568, 570, 571, 579, 580, 581, 582]"
leakcanary,24654,1129,1094,35,"[1, 2, 3, 4, 7, 8, 9, 10, 11, 12, 13, 15, 18, 19, 20, 21, 22, 23, 25, 26, 29, 31, 32, 37, 39, 42, 44, 45, 46, 47, 48, 49, 53, 54, 55, 56, 57, 60, 61, 62, 65, 69, 70, 71, 72, 75, 76, 77, 85, 86, 87, 88, 91, 92, 93, 94, 95, 97, 101, 102, 110, 116, 119, 120, 127, 128, 129, 130, 131, 132, 133, 135, 136, 137, 138, 139, 141, 142, 143, 144, 146, 147, 148, 149, 151, 152, 154, 155, 156, 157, 159, 160, 162, 163, 164, 165, 167, 169, 170, 171]"
python-patterns,24608,61,52,9,"[1, 3, 8, 20, 21, 29, 41, 42, 53, 54, 57, 64, 70, 88, 90, 117, 120, 127, 134, 140, 143, 149, 150, 154, 158, 159, 163, 165, 171, 177, 182, 184, 185, 208, 217, 226, 228, 233, 238, 239, 244, 245, 247, 248, 250, 252, 254, 258, 259, 264, 272, 275, 277, 278, 279, 295, 298, 300, 310, 313, 324]"
awesome-java,24554,96,95,1,"[3, 4, 8, 9, 12, 14, 19, 25, 28, 40, 68, 81, 90, 91, 94, 103, 107, 120, 172, 178, 190, 193, 205, 208, 218, 227, 232, 247, 261, 264, 266, 267, 268, 284, 290, 293, 295, 319, 336, 337, 346, 348, 350, 351, 358, 371, 372, 384, 386, 389, 393, 407, 410, 439, 450, 462, 471, 482, 485, 486, 489, 491, 502, 503, 511, 525, 530, 537, 549, 566, 567, 570, 581, 588, 599, 626, 639, 641, 642, 661, 669, 670, 672, 676, 686, 697, 698, 722, 743, 744, 797, 801, 807, 812, 836, 838]"
JCSprout,24548,87,59,28,"[1, 2, 4, 5, 9, 15, 16, 19, 20, 26, 28, 31, 32, 33, 36, 37, 39, 40, 41, 45, 46, 47, 49, 50, 59, 60, 61, 65, 69, 72, 81, 83, 84, 86, 88, 89, 90, 91, 93, 94, 95, 97, 102, 104, 107, 109, 110, 112, 114, 115, 117, 122, 124, 125, 131, 132, 133, 134, 140, 141, 143, 146, 149, 150, 151, 152, 156, 157, 160, 161, 162, 164, 165, 166, 167, 168, 169, 170, 174, 175, 180, 188, 190, 191, 194, 195, 196]"
request,24544,2142,2005,137,"[4, 5, 6, 7, 8, 9, 10, 11, 12, 13, 14, 17, 21, 23, 24, 25, 26, 27, 28, 29, 32, 33, 34, 36, 37, 38, 39, 40, 42, 43, 44, 46, 47, 48, 49, 51, 52, 54, 56, 57, 58, 59, 60, 63, 64, 71, 72, 74, 77, 80, 82, 83, 85, 87, 88, 89, 91, 92, 98, 99, 100, 101, 103, 107, 108, 109, 113, 114, 115, 116, 118, 119, 120, 122, 123, 124, 125, 126, 128, 129, 130, 134, 136, 137, 138, 140, 141, 142, 143, 145, 147, 149, 150, 152, 153, 154, 155, 156, 158, 159]"
nylas-mail,24525,3421,2416,1005,"[1, 2, 3, 4, 5, 6, 7, 8, 9, 10, 12, 13, 14, 17, 18, 19, 20, 21, 22, 23, 24, 25, 26, 27, 28, 29, 32, 33, 34, 35, 36, 37, 38, 39, 40, 42, 44, 45, 46, 47, 48, 51, 54, 55, 56, 57, 58, 59, 60, 61, 62, 63, 65, 66, 69, 71, 72, 73, 74, 75, 76, 77, 78, 80, 81, 82, 83, 86, 87, 89, 90, 91, 92, 94, 95, 96, 97, 98, 99, 100, 101, 102, 103, 104, 105, 106, 107, 108, 110, 111, 115, 116, 117, 118, 119, 120, 122, 123, 124, 125]"
weui,24484,607,583,24,"[1, 2, 3, 4, 5, 6, 7, 8, 9, 10, 14, 15, 16, 19, 21, 23, 25, 26, 27, 28, 29, 31, 34, 35, 38, 40, 48, 60, 69, 73, 80, 81, 85, 86, 92, 96, 97, 101, 102, 104, 108, 112, 113, 118, 125, 129, 133, 134, 135, 136, 138, 140, 145, 148, 149, 151, 155, 157, 158, 159, 160, 161, 162, 163, 167, 170, 171, 173, 175, 176, 181, 182, 184, 187, 188, 189, 190, 191, 193, 194, 195, 198, 199, 200, 207, 208, 210, 213, 215, 216, 218, 220, 221, 222, 224, 226, 227, 230, 231, 234]"
pure-bash-bible,24439,47,23,24,"[1, 2, 8, 9, 11, 16, 17, 18, 19, 21, 22, 25, 27, 29, 32, 34, 36, 38, 41, 44, 45, 49, 53, 57, 58, 60, 61, 62, 63, 69, 70, 72, 73, 76, 82, 83, 85, 86, 87, 88, 90, 92, 94, 95, 100, 101, 102]"
SecLists,24427,106,98,8,"[1, 4, 5, 27, 31, 33, 34, 36, 37, 40, 45, 50, 51, 52, 54, 59, 63, 69, 70, 75, 79, 80, 88, 89, 96, 97, 99, 100, 101, 105, 108, 112, 114, 115, 116, 127, 129, 131, 132, 135, 137, 138, 139, 140, 143, 144, 148, 154, 165, 166, 167, 169, 172, 173, 179, 181, 184, 187, 188, 193, 195, 200, 215, 217, 226, 233, 235, 245, 255, 257, 259, 275, 284, 288, 291, 293, 294, 308, 309, 319, 320, 327, 329, 339, 344, 345, 348, 356, 367, 375, 376, 377, 384, 386, 392, 393, 397, 398, 407, 408]"
strapi,24416,3431,3193,238,"[3, 4, 5, 6, 7, 8, 9, 10, 11, 13, 15, 18, 29, 35, 36, 38, 39, 40, 41, 47, 48, 49, 51, 52, 53, 54, 55, 56, 57, 58, 59, 60, 61, 62, 63, 66, 67, 68, 69, 70, 71, 72, 73, 74, 75, 76, 77, 78, 80, 81, 83, 84, 85, 86, 88, 89, 90, 91, 92, 93, 94, 95, 99, 100, 101, 102, 103, 104, 105, 109, 110, 111, 112, 113, 115, 116, 117, 120, 121, 122, 123, 124, 125, 126, 127, 128, 129, 130, 131, 132, 133, 134, 135, 136, 141, 143, 144, 145, 146, 148]"
select2,24411,4456,4416,40,"[1, 2, 3, 4, 7, 8, 9, 11, 12, 13, 14, 16, 17, 18, 19, 20, 23, 24, 26, 27, 28, 29, 30, 31, 33, 34, 35, 37, 38, 39, 40, 41, 42, 43, 45, 47, 48, 49, 50, 51, 52, 53, 54, 55, 58, 59, 60, 61, 62, 65, 66, 67, 68, 69, 70, 72, 74, 75, 76, 77, 78, 79, 80, 81, 82, 83, 84, 87, 88, 89, 90, 91, 92, 93, 94, 95, 96, 97, 98, 99, 100, 101, 102, 103, 104, 106, 108, 109, 110, 112, 113, 115, 116, 117, 118, 119, 120, 123, 124, 126]"
wrk,24357,308,221,87,"[1, 2, 3, 6, 8, 11, 13, 15, 19, 22, 24, 25, 26, 27, 28, 29, 31, 32, 33, 34, 35, 37, 38, 39, 40, 41, 42, 43, 44, 45, 46, 47, 48, 49, 50, 51, 52, 53, 55, 56, 59, 60, 62, 63, 64, 66, 67, 68, 69, 70, 71, 72, 75, 76, 77, 80, 81, 82, 83, 84, 85, 87, 88, 90, 91, 92, 93, 94, 95, 96, 97, 99, 100, 101, 103, 104, 106, 109, 110, 112, 114, 115, 116, 118, 119, 120, 122, 124, 125, 127, 128, 129, 130, 131, 132, 133, 134, 135, 136, 137]"
localstack,24338,1499,1260,239,"[1, 3, 4, 7, 10, 13, 14, 17, 21, 23, 25, 26, 27, 28, 30, 31, 32, 33, 34, 35, 37, 38, 39, 40, 42, 43, 45, 46, 50, 51, 52, 53, 54, 55, 56, 57, 58, 59, 60, 61, 62, 63, 64, 65, 66, 67, 68, 69, 70, 71, 72, 74, 75, 77, 78, 79, 80, 81, 82, 83, 84, 85, 87, 88, 89, 90, 91, 92, 93, 96, 97, 98, 99, 100, 101, 102, 103, 104, 105, 106, 107, 108, 109, 110, 111, 112, 113, 114, 115, 116, 117, 118, 119, 120, 121, 122, 123, 124, 125, 126]"
Modernizr,24337,1416,1260,156,"[1, 2, 3, 4, 5, 6, 7, 8, 9, 10, 11, 12, 13, 14, 15, 16, 17, 18, 19, 20, 21, 22, 23, 24, 25, 26, 27, 28, 29, 30, 31, 32, 33, 34, 35, 36, 37, 38, 39, 40, 41, 42, 43, 44, 45, 46, 47, 48, 49, 50, 51, 52, 53, 54, 55, 56, 57, 58, 59, 60, 61, 62, 63, 64, 65, 66, 67, 68, 69, 70, 71, 72, 73, 74, 75, 76, 77, 78, 79, 80, 81, 82, 83, 84, 85, 86, 87, 88, 89, 90, 91, 92, 93, 94, 95, 96, 97, 98, 99, 100]"
styleguide,24247,225,77,148,"[1, 2, 3, 4, 5, 6, 7, 8, 9, 10, 11, 12, 13, 14, 15, 16, 17, 18, 19, 20, 21, 22, 23, 24, 25, 26, 27, 28, 29, 30, 31, 32, 33, 34, 35, 36, 37, 38, 39, 40, 41, 42, 43, 50, 51, 53, 55, 56, 61, 62, 65, 66, 67, 69, 77, 78, 79, 83, 84, 89, 90, 93, 95, 97, 98, 103, 107, 112, 113, 114, 117, 119, 122, 123, 126, 127, 132, 133, 138, 140, 143, 145, 146, 150, 152, 157, 161, 164, 165, 168, 171, 173, 174, 176, 177, 178, 179, 181, 186, 194]"
angular-styleguide,24195,423,361,62,"[2, 5, 6, 8, 10, 11, 12, 13, 14, 15, 16, 18, 20, 21, 22, 27, 33, 34, 35, 38, 39, 42, 43, 45, 46, 48, 50, 51, 52, 54, 56, 58, 59, 60, 61, 62, 63, 64, 65, 68, 69, 70, 71, 73, 77, 78, 79, 80, 81, 82, 86, 87, 89, 91, 92, 93, 95, 96, 99, 107, 108, 111, 114, 117, 119, 121, 122, 132, 133, 134, 138, 157, 158, 162, 164, 165, 169, 170, 171, 175, 176, 177, 181, 184, 186, 189, 190, 191, 194, 199, 201, 207, 208, 212, 213, 214, 218, 226, 228, 242]"
lessons,24105,18,18,0,"[69, 76, 78, 83, 90, 97, 107, 121, 128, 131, 132, 136, 153, 164, 166, 168, 169, 170]"
front-end-interview-handbook,24036,0,0,0,[]
mkcert,23952,170,133,37,"[1, 6, 7, 8, 9, 10, 11, 12, 14, 17, 20, 21, 22, 24, 28, 30, 31, 35, 39, 41, 42, 43, 44, 45, 47, 49, 50, 51, 52, 53, 56, 60, 64, 66, 67, 69, 70, 72, 73, 76, 78, 79, 80, 81, 83, 84, 86, 88, 92, 94, 95, 96, 97, 98, 99, 101, 104, 105, 106, 107, 111, 112, 114, 115, 116, 118, 119, 120, 122, 123, 125, 126, 127, 128, 129, 130, 131, 132, 133, 134, 135, 136, 138, 140, 143, 144, 145, 146, 147, 148, 149, 150, 151, 153, 154, 155, 156, 157, 158, 159]"
hangzhou_house_knowledge,23893,0,0,0,[]
gitflow,23858,335,114,221,"[1, 2, 3, 4, 5, 6, 7, 8, 9, 10, 11, 12, 13, 14, 15, 16, 17, 18, 19, 20, 21, 22, 23, 24, 25, 26, 27, 28, 29, 30, 31, 32, 33, 34, 35, 36, 37, 38, 39, 40, 41, 42, 43, 44, 45, 46, 47, 48, 49, 50, 52, 53, 54, 55, 58, 59, 60, 61, 62, 64, 65, 66, 73, 74, 75, 78, 79, 81, 82, 86, 87, 88, 89, 90, 91, 92, 93, 94, 95, 96, 97, 98, 100, 101, 102, 103, 104, 105, 106, 107, 108, 110, 111, 113, 114, 118, 121, 122, 124, 125]"
Faker,23825,541,486,55,"[1, 2, 3, 4, 5, 10, 14, 23, 32, 34, 36, 38, 39, 42, 47, 54, 62, 63, 66, 68, 78, 90, 93, 97, 103, 104, 109, 113, 115, 117, 118, 120, 124, 129, 130, 137, 140, 142, 158, 168, 169, 171, 177, 184, 186, 189, 191, 196, 198, 200, 203, 213, 214, 216, 219, 220, 223, 239, 240, 241, 244, 251, 255, 265, 267, 268, 282, 284, 287, 293, 294, 299, 303, 304, 305, 308, 313, 314, 315, 328, 329, 330, 331, 338, 340, 342, 344, 347, 353, 360, 361, 364, 365, 367, 376, 382, 384, 388, 392, 396]"
beego,23791,2699,1909,790,"[1, 2, 4, 6, 11, 12, 13, 14, 15, 16, 17, 18, 20, 23, 24, 25, 26, 27, 28, 29, 30, 31, 34, 35, 36, 37, 38, 39, 42, 43, 45, 47, 48, 52, 53, 57, 60, 64, 65, 66, 67, 69, 77, 78, 79, 80, 81, 87, 88, 89, 90, 91, 94, 95, 96, 97, 99, 107, 108, 110, 117, 119, 120, 121, 123, 124, 126, 127, 128, 129, 130, 131, 132, 133, 134, 135, 136, 137, 138, 139, 140, 141, 142, 144, 145, 146, 148, 149, 151, 152, 153, 154, 155, 158, 159, 160, 161, 162, 163, 164]"
Java,23706,170,128,42,"[9, 20, 49, 65, 84, 88, 89, 91, 92, 96, 104, 105, 110, 125, 144, 157, 167, 304, 310, 320, 336, 338, 340, 345, 348, 355, 356, 363, 371, 376, 379, 385, 388, 390, 391, 393, 394, 395, 396, 402, 405, 416, 426, 427, 431, 436, 437, 450, 454, 458, 459, 462, 464, 465, 466, 471, 473, 474, 475, 477, 482, 492, 495, 496, 497, 504, 515, 520, 546, 560, 607, 627, 633, 638, 641, 642, 644, 651, 653, 667, 674, 676, 679, 680, 682, 689, 698, 699, 700, 704, 705, 708, 719, 727, 728, 729, 733, 741, 749, 765]"
machine-learning-for-software-engineers,23692,15,3,12,"[2, 3, 7, 16, 41, 45, 46, 50, 54, 68, 71, 73, 79, 84, 85]"
standard,23668,1072,964,108,"[1, 2, 3, 5, 6, 7, 8, 9, 10, 11, 12, 13, 15, 16, 18, 20, 21, 22, 24, 26, 28, 31, 32, 33, 34, 36, 37, 40, 42, 43, 45, 46, 47, 49, 50, 51, 56, 58, 59, 60, 61, 62, 64, 65, 67, 68, 69, 70, 71, 72, 73, 74, 75, 77, 78, 79, 80, 81, 82, 83, 85, 86, 87, 88, 89, 91, 93, 94, 95, 96, 97, 98, 99, 101, 103, 104, 105, 106, 108, 109, 110, 111, 112, 114, 115, 116, 117, 119, 120, 121, 122, 123, 125, 126, 128, 129, 130, 131, 132, 133]"
carbon,23666,424,406,18,"[1, 6, 20, 25, 26, 28, 29, 30, 31, 32, 33, 34, 36, 37, 38, 42, 44, 45, 46, 47, 48, 49, 50, 51, 52, 54, 59, 60, 62, 64, 65, 66, 67, 68, 72, 74, 75, 79, 81, 83, 84, 85, 86, 91, 92, 98, 99, 105, 107, 110, 112, 113, 114, 119, 121, 122, 123, 125, 128, 130, 134, 135, 136, 137, 139, 140, 142, 145, 147, 150, 152, 153, 154, 158, 160, 161, 163, 168, 170, 171, 173, 175, 177, 178, 179, 180, 181, 182, 184, 185, 186, 187, 188, 192, 193, 194, 197, 198, 201, 202]"
iina,23660,2316,1457,859,"[1, 2, 3, 4, 5, 6, 7, 8, 9, 10, 11, 12, 13, 14, 15, 16, 17, 18, 19, 20, 21, 22, 23, 24, 25, 26, 27, 28, 30, 31, 32, 33, 34, 35, 36, 37, 38, 39, 41, 42, 43, 44, 45, 46, 48, 49, 51, 55, 56, 57, 58, 60, 62, 63, 65, 66, 67, 68, 70, 71, 72, 73, 74, 75, 79, 81, 82, 83, 84, 85, 86, 92, 93, 94, 95, 96, 97, 98, 99, 100, 101, 102, 103, 106, 107, 108, 109, 110, 113, 114, 115, 118, 119, 120, 121, 122, 123, 124, 125, 126]"
vuex,23648,989,954,35,"[1, 2, 3, 11, 13, 15, 16, 17, 18, 20, 21, 24, 25, 26, 29, 31, 33, 34, 36, 37, 38, 41, 42, 43, 45, 46, 47, 48, 50, 51, 52, 54, 56, 57, 59, 60, 62, 67, 68, 70, 72, 73, 75, 76, 77, 78, 79, 81, 82, 83, 84, 85, 86, 87, 88, 90, 91, 92, 93, 94, 96, 97, 98, 99, 100, 101, 104, 107, 109, 112, 114, 115, 119, 121, 127, 130, 131, 132, 133, 135, 136, 139, 143, 144, 145, 147, 148, 149, 150, 153, 154, 155, 156, 157, 158, 159, 161, 162, 165, 166]"
trackerslist,23621,211,209,2,"[1, 2, 3, 4, 5, 6, 7, 8, 9, 11, 12, 13, 14, 15, 16, 17, 18, 19, 20, 21, 22, 23, 24, 25, 26, 27, 28, 29, 30, 32, 33, 34, 36, 37, 38, 39, 40, 41, 42, 43, 44, 45, 46, 47, 49, 50, 51, 52, 53, 54, 55, 56, 57, 58, 59, 60, 61, 62, 63, 65, 66, 67, 68, 69, 70, 71, 72, 73, 77, 78, 79, 81, 82, 83, 85, 86, 87, 88, 89, 90, 91, 92, 93, 94, 96, 98, 100, 101, 102, 103, 104, 105, 106, 107, 108, 109, 110, 111, 112, 113]"
rethinkdb,23546,6246,4850,1396,"[2, 3, 5, 6, 7, 9, 11, 12, 13, 14, 15, 16, 17, 18, 19, 20, 21, 22, 24, 25, 26, 27, 28, 29, 30, 31, 32, 33, 34, 35, 36, 37, 38, 39, 40, 41, 42, 43, 44, 45, 46, 47, 48, 49, 50, 51, 52, 53, 56, 58, 59, 60, 61, 62, 63, 64, 65, 67, 68, 69, 70, 71, 72, 73, 74, 75, 76, 77, 78, 79, 80, 81, 82, 83, 84, 85, 87, 88, 89, 90, 91, 92, 93, 94, 95, 96, 97, 98, 99, 100, 101, 102, 103, 104, 105, 106, 107, 108, 109, 110]"
fetch,23537,498,488,10,"[2, 4, 6, 9, 11, 14, 15, 16, 17, 20, 21, 25, 33, 34, 35, 37, 40, 41, 42, 43, 45, 46, 47, 51, 61, 80, 83, 88, 89, 90, 91, 93, 94, 96, 103, 104, 106, 108, 109, 111, 114, 115, 118, 121, 122, 123, 125, 126, 128, 129, 131, 133, 134, 135, 137, 138, 139, 141, 142, 143, 145, 146, 147, 148, 149, 151, 152, 153, 154, 155, 160, 162, 163, 166, 167, 168, 169, 170, 171, 172, 173, 175, 176, 177, 178, 180, 181, 182, 183, 184, 185, 186, 187, 190, 193, 194, 197, 198, 199, 200]"
awesome-php,23536,107,105,2,"[1, 2, 3, 8, 10, 13, 14, 15, 18, 29, 30, 32, 46, 61, 62, 79, 88, 90, 94, 102, 107, 108, 110, 123, 153, 168, 172, 179, 181, 193, 205, 210, 237, 238, 248, 261, 275, 286, 289, 290, 302, 305, 313, 317, 319, 353, 364, 366, 371, 387, 393, 405, 423, 426, 435, 437, 461, 466, 473, 504, 508, 509, 514, 516, 532, 535, 572, 617, 623, 627, 630, 633, 656, 657, 667, 674, 681, 686, 687, 690, 707, 800, 810, 835, 842, 848, 853, 855, 865, 870, 878, 885, 886, 926, 928, 930, 973, 981, 985, 1001]"
swiper,23526,3157,2988,169,"[1, 2, 3, 5, 6, 8, 9, 10, 11, 13, 14, 15, 16, 17, 18, 19, 20, 21, 22, 23, 24, 25, 26, 27, 28, 29, 30, 31, 32, 33, 35, 36, 37, 38, 39, 40, 41, 42, 43, 44, 45, 46, 47, 48, 49, 50, 51, 52, 53, 54, 55, 56, 57, 58, 59, 60, 61, 62, 63, 64, 65, 66, 67, 68, 69, 70, 71, 72, 73, 74, 75, 76, 77, 78, 79, 80, 81, 82, 83, 84, 85, 86, 87, 88, 89, 90, 91, 92, 93, 94, 95, 96, 97, 98, 99, 101, 102, 103, 104, 105]"
new-pac,23515,875,690,185,"[1, 2, 3, 4, 5, 6, 7, 8, 9, 10, 11, 12, 13, 14, 15, 16, 17, 18, 19, 20, 21, 22, 23, 24, 25, 26, 27, 28, 29, 30, 31, 32, 33, 34, 35, 36, 37, 38, 39, 40, 41, 42, 43, 44, 45, 46, 47, 48, 49, 50, 51, 52, 53, 55, 56, 57, 58, 59, 60, 61, 62, 63, 64, 65, 66, 67, 68, 69, 71, 72, 73, 74, 75, 76, 77, 78, 79, 80, 81, 82, 83, 84, 85, 86, 87, 88, 89, 90, 91, 92, 93, 94, 95, 96, 97, 98, 99, 100, 101, 102]"
faker.js,23424,426,239,187,"[1, 2, 3, 4, 5, 7, 9, 25, 26, 28, 30, 33, 34, 35, 36, 38, 39, 41, 42, 45, 53, 54, 55, 57, 58, 60, 61, 63, 68, 69, 71, 72, 78, 84, 91, 92, 93, 104, 105, 107, 110, 116, 117, 118, 119, 122, 124, 125, 126, 128, 132, 133, 134, 136, 137, 139, 141, 142, 143, 148, 153, 155, 156, 159, 161, 162, 167, 168, 169, 170, 171, 175, 176, 179, 183, 185, 189, 190, 192, 196, 197, 199, 201, 202, 203, 210, 213, 214, 216, 220, 221, 222, 223, 226, 228, 229, 231, 232, 233, 235]"
tidb,23411,4453,3044,1409,"[12, 18, 19, 21, 25, 36, 45, 47, 48, 49, 53, 54, 55, 56, 57, 59, 62, 66, 67, 68, 73, 77, 81, 82, 83, 84, 85, 88, 91, 95, 107, 108, 112, 120, 124, 129, 149, 158, 164, 165, 166, 173, 174, 175, 176, 177, 178, 179, 188, 193, 194, 197, 199, 203, 204, 212, 216, 222, 224, 228, 230, 231, 234, 236, 238, 239, 240, 241, 242, 243, 244, 245, 254, 257, 258, 261, 263, 266, 271, 273, 277, 278, 279, 282, 283, 286, 288, 294, 295, 299, 300, 301, 307, 310, 312, 318, 320, 322, 323, 324]"
netty,23394,5049,4681,368,"[35, 58, 59, 60, 61, 62, 63, 64, 65, 66, 67, 68, 69, 71, 72, 74, 76, 77, 78, 79, 81, 82, 83, 84, 86, 87, 88, 89, 90, 93, 94, 97, 100, 101, 102, 103, 104, 106, 107, 108, 110, 111, 112, 113, 116, 120, 122, 125, 129, 130, 133, 134, 137, 138, 140, 141, 142, 143, 144, 145, 146, 147, 148, 149, 153, 156, 157, 160, 161, 163, 164, 165, 166, 167, 168, 169, 170, 171, 173, 175, 178, 179, 180, 181, 182, 183, 186, 187, 188, 189, 190, 192, 195, 200, 202, 203, 204, 205, 207, 208]"
BaiduPCS-Go,23382,917,789,128,"[1, 2, 3, 4, 5, 7, 9, 10, 11, 12, 13, 14, 15, 16, 17, 18, 19, 20, 21, 22, 23, 24, 25, 26, 27, 28, 29, 30, 31, 32, 33, 34, 35, 36, 37, 38, 39, 40, 41, 42, 44, 45, 46, 47, 48, 49, 50, 51, 52, 53, 54, 55, 56, 57, 58, 60, 61, 62, 63, 64, 65, 66, 67, 68, 69, 70, 71, 72, 73, 74, 75, 76, 77, 78, 79, 80, 81, 82, 83, 84, 85, 86, 87, 88, 89, 90, 91, 92, 93, 94, 95, 96, 97, 98, 99, 100, 101, 102, 103, 104]"
awesome-macos-command-line,23350,0,0,0,[]
PythonDataScienceHandbook,23322,114,46,68,"[1, 2, 3, 4, 5, 6, 7, 8, 9, 10, 11, 12, 13, 14, 15, 16, 17, 18, 19, 20, 21, 25, 26, 27, 28, 29, 31, 34, 36, 37, 38, 44, 56, 59, 62, 63, 64, 67, 68, 69, 70, 71, 72, 75, 79, 83, 85, 86, 87, 91, 94, 104, 108, 112, 114, 118, 122, 123, 125, 126, 128, 130, 136, 137, 138, 139, 140, 142, 143, 146, 147, 148, 151, 154, 158, 160, 163, 164, 165, 170, 171, 172, 174, 175, 176, 178, 179, 184, 185, 186, 192, 193, 195, 196, 197, 198, 204, 205, 207, 209]"
angular-cli,23316,11675,11044,631,"[1, 2, 3, 4, 5, 6, 7, 8, 9, 10, 11, 12, 13, 14, 15, 16, 19, 22, 23, 24, 25, 28, 29, 34, 36, 38, 40, 41, 42, 43, 44, 47, 48, 49, 50, 51, 52, 53, 54, 55, 57, 58, 60, 61, 63, 64, 66, 67, 68, 70, 72, 73, 74, 75, 78, 81, 83, 84, 87, 90, 91, 92, 93, 95, 96, 101, 102, 103, 107, 113, 116, 117, 118, 120, 124, 125, 127, 129, 130, 131, 132, 136, 140, 143, 148, 152, 153, 156, 158, 159, 161, 162, 164, 166, 167, 172, 174, 176, 178, 181]"
open-source-ios-apps,23258,202,201,1,"[1, 6, 7, 14, 15, 16, 17, 19, 22, 24, 25, 26, 27, 28, 29, 31, 32, 33, 35, 36, 39, 41, 42, 44, 45, 51, 53, 56, 59, 62, 63, 67, 70, 72, 73, 76, 77, 78, 82, 89, 94, 96, 98, 107, 112, 115, 120, 124, 125, 126, 128, 132, 134, 141, 142, 146, 156, 161, 163, 166, 169, 170, 175, 177, 195, 198, 201, 205, 208, 215, 216, 232, 240, 246, 253, 255, 256, 261, 267, 280, 282, 285, 289, 298, 302, 304, 309, 312, 313, 316, 321, 323, 324, 325, 326, 330, 334, 339, 347, 349]"
dotfiles,23225,354,228,126,"[1, 2, 4, 5, 6, 8, 9, 11, 22, 23, 24, 27, 28, 30, 31, 32, 33, 34, 35, 36, 39, 41, 43, 48, 54, 56, 64, 69, 70, 80, 82, 83, 85, 90, 91, 92, 94, 99, 100, 102, 104, 106, 107, 108, 110, 113, 114, 115, 120, 121, 127, 132, 134, 138, 148, 149, 152, 153, 154, 159, 165, 171, 177, 182, 184, 185, 186, 190, 193, 195, 196, 200, 201, 205, 208, 210, 222, 224, 225, 228, 229, 230, 231, 235, 237, 240, 242, 243, 257, 260, 262, 263, 264, 270, 273, 274, 275, 276, 279, 281]"
iview,23219,5421,4432,989,"[1, 2, 3, 5, 6, 7, 9, 10, 11, 12, 13, 14, 15, 16, 17, 18, 19, 20, 21, 22, 23, 24, 25, 26, 27, 28, 29, 30, 32, 33, 34, 36, 38, 41, 44, 46, 47, 48, 49, 50, 52, 53, 54, 55, 56, 57, 58, 59, 60, 61, 62, 64, 65, 66, 67, 68, 69, 70, 71, 72, 73, 74, 75, 77, 78, 79, 82, 83, 84, 86, 87, 88, 90, 92, 93, 94, 96, 97, 101, 102, 103, 104, 106, 108, 110, 111, 112, 113, 114, 115, 116, 117, 118, 119, 120, 121, 122, 123, 124, 125]"
Detectron,23198,881,602,279,"[1, 3, 4, 5, 6, 7, 8, 10, 12, 13, 14, 16, 17, 18, 19, 20, 21, 22, 23, 24, 25, 26, 27, 28, 29, 30, 31, 32, 33, 34, 35, 36, 38, 39, 40, 41, 42, 43, 44, 45, 46, 47, 48, 49, 51, 52, 53, 54, 55, 56, 57, 58, 59, 60, 61, 62, 63, 64, 65, 66, 67, 68, 69, 70, 71, 72, 73, 74, 75, 76, 77, 78, 79, 80, 81, 82, 83, 84, 85, 86, 87, 88, 89, 91, 92, 93, 94, 95, 96, 97, 98, 99, 100, 101, 102, 103, 104, 105, 106, 107]"
symfony,23182,13969,13229,740,"[752, 754, 755, 759, 761, 763, 766, 768, 769, 770, 772, 779, 780, 784, 787, 794, 795, 796, 798, 800, 803, 817, 819, 820, 831, 835, 836, 837, 838, 839, 840, 841, 847, 853, 854, 855, 856, 859, 860, 861, 863, 865, 866, 874, 883, 884, 885, 889, 890, 893, 897, 899, 900, 902, 904, 908, 913, 917, 918, 920, 922, 926, 928, 929, 949, 961, 964, 971, 974, 975, 976, 977, 983, 986, 988, 991, 997, 1001, 1004, 1008, 1015, 1019, 1021, 1024, 1026, 1033, 1035, 1036, 1044, 1045, 1048, 1051, 1052, 1054, 1058, 1066, 1070, 1077, 1082, 1083]"
nativefier,23109,780,610,170,"[1, 2, 3, 7, 9, 10, 11, 12, 14, 15, 16, 17, 18, 19, 21, 22, 23, 27, 28, 29, 30, 31, 32, 34, 35, 37, 38, 39, 40, 41, 42, 43, 44, 45, 46, 49, 50, 51, 52, 53, 54, 55, 56, 57, 59, 61, 64, 68, 69, 70, 71, 72, 73, 74, 76, 77, 78, 80, 81, 82, 83, 84, 85, 86, 87, 88, 89, 91, 92, 93, 94, 95, 96, 97, 98, 99, 100, 101, 102, 103, 104, 105, 106, 108, 109, 113, 115, 116, 117, 118, 119, 120, 121, 122, 123, 124, 125, 127, 128, 129]"
devdocs,22952,816,718,98,"[2, 3, 4, 5, 6, 7, 8, 9, 11, 12, 13, 14, 16, 18, 19, 20, 21, 23, 24, 25, 26, 27, 28, 30, 31, 32, 34, 35, 36, 37, 38, 39, 40, 41, 42, 43, 44, 45, 46, 48, 51, 52, 53, 54, 55, 56, 57, 58, 59, 60, 61, 63, 64, 65, 66, 68, 70, 71, 72, 73, 74, 75, 77, 78, 79, 80, 81, 82, 83, 84, 85, 86, 87, 88, 89, 92, 95, 96, 97, 98, 100, 101, 102, 103, 104, 105, 106, 107, 108, 109, 111, 112, 115, 116, 117, 118, 119, 120, 121, 122]"
composer,22954,5922,5582,340,"[6, 7, 14, 15, 24, 25, 26, 27, 28, 30, 31, 32, 34, 35, 36, 38, 39, 42, 43, 45, 46, 47, 49, 50, 51, 52, 53, 54, 55, 56, 57, 58, 59, 63, 64, 65, 70, 73, 74, 75, 76, 78, 81, 82, 83, 84, 85, 86, 89, 91, 92, 93, 94, 96, 97, 98, 102, 105, 106, 112, 113, 114, 117, 121, 124, 125, 127, 128, 129, 130, 133, 135, 137, 139, 144, 157, 158, 159, 160, 161, 162, 166, 168, 169, 170, 172, 177, 179, 181, 183, 185, 186, 187, 189, 190, 193, 194, 195, 196, 197]"
CodeHub,22892,605,387,218,"[1, 3, 5, 6, 7, 8, 9, 10, 11, 12, 13, 14, 15, 17, 18, 19, 20, 21, 22, 23, 24, 25, 26, 27, 29, 30, 31, 32, 33, 34, 35, 36, 37, 38, 39, 40, 41, 42, 43, 44, 45, 46, 47, 48, 49, 50, 51, 52, 53, 54, 55, 56, 57, 58, 59, 60, 61, 62, 63, 64, 65, 66, 67, 68, 69, 70, 71, 72, 73, 74, 75, 76, 77, 78, 79, 80, 81, 82, 83, 84, 85, 86, 87, 88, 89, 90, 91, 92, 93, 94, 95, 96, 97, 98, 99, 100, 101, 102, 103, 104]"
bert,22836,922,296,626,"[1, 2, 3, 4, 5, 8, 9, 11, 12, 13, 15, 16, 17, 18, 20, 21, 22, 23, 24, 26, 27, 28, 29, 30, 32, 33, 34, 35, 38, 39, 40, 42, 43, 44, 45, 46, 47, 48, 49, 50, 51, 53, 54, 55, 57, 58, 59, 60, 61, 62, 63, 64, 65, 66, 67, 70, 71, 72, 74, 75, 77, 80, 81, 82, 83, 84, 85, 86, 88, 89, 90, 91, 92, 94, 95, 98, 99, 100, 101, 102, 103, 104, 106, 107, 108, 109, 110, 112, 113, 114, 115, 116, 117, 118, 121, 122, 123, 124, 125, 126]"
swift-algorithm-club,22793,183,174,9,"[1, 10, 11, 29, 31, 35, 36, 44, 52, 53, 54, 59, 61, 67, 72, 74, 75, 83, 85, 97, 99, 100, 101, 108, 110, 111, 120, 123, 129, 130, 133, 137, 140, 141, 144, 147, 153, 155, 159, 160, 162, 169, 170, 171, 175, 177, 180, 181, 188, 202, 204, 206, 209, 210, 222, 223, 224, 225, 226, 227, 244, 245, 246, 249, 254, 272, 284, 285, 286, 287, 296, 307, 309, 312, 314, 316, 317, 320, 325, 327, 329, 339, 340, 341, 342, 354, 357, 359, 363, 373, 378, 380, 387, 396, 406, 407, 410, 418, 439, 455]"
jieba,22773,689,186,503,"[1, 2, 3, 4, 5, 6, 7, 8, 9, 11, 12, 14, 15, 17, 18, 19, 20, 22, 23, 24, 25, 26, 27, 28, 29, 30, 31, 32, 33, 34, 35, 36, 37, 38, 41, 42, 43, 44, 47, 49, 51, 52, 54, 55, 56, 57, 58, 59, 60, 61, 62, 63, 64, 65, 67, 68, 69, 70, 73, 76, 77, 78, 79, 80, 82, 83, 85, 86, 87, 88, 89, 90, 91, 92, 93, 94, 95, 96, 97, 98, 102, 103, 104, 105, 108, 109, 110, 111, 112, 115, 116, 117, 118, 119, 120, 121, 122, 123, 124, 125]"
Hover,22702,96,79,17,"[4, 5, 8, 9, 10, 14, 16, 17, 18, 19, 22, 24, 25, 26, 27, 28, 29, 30, 31, 32, 33, 35, 36, 37, 38, 39, 41, 45, 49, 52, 57, 58, 59, 61, 62, 63, 65, 67, 68, 69, 70, 71, 72, 73, 74, 77, 78, 79, 80, 82, 83, 86, 87, 89, 90, 91, 92, 93, 94, 96, 97, 98, 99, 102, 103, 104, 105, 106, 107, 108, 109, 110, 111, 113, 114, 115, 116, 119, 120, 121, 123, 124, 127, 129, 131, 132, 133, 134, 135, 137, 142, 143, 144, 149, 150, 160]"
Charts,22697,3622,3121,501,"[2, 3, 4, 6, 7, 8, 10, 11, 12, 14, 15, 16, 17, 18, 19, 21, 23, 24, 26, 27, 28, 29, 30, 31, 33, 34, 35, 36, 38, 39, 40, 41, 42, 43, 44, 46, 47, 48, 49, 50, 51, 52, 53, 54, 55, 57, 58, 59, 60, 61, 62, 63, 64, 65, 67, 68, 69, 70, 71, 72, 73, 75, 77, 78, 79, 80, 81, 82, 83, 84, 85, 86, 87, 88, 89, 90, 91, 92, 94, 96, 97, 98, 99, 100, 101, 102, 103, 104, 105, 108, 109, 110, 111, 112, 113, 114, 115, 116, 117, 118]"
istio,22668,9539,8429,1110,"[2, 4, 6, 7, 18, 31, 37, 38, 39, 52, 57, 76, 81, 82, 97, 98, 99, 100, 106, 108, 118, 119, 127, 141, 142, 146, 154, 160, 164, 166, 173, 176, 178, 183, 185, 186, 187, 188, 189, 190, 191, 196, 199, 201, 211, 213, 214, 215, 216, 217, 218, 219, 220, 226, 230, 232, 234, 235, 237, 239, 240, 241, 242, 245, 249, 250, 252, 253, 254, 255, 259, 260, 261, 263, 268, 271, 277, 280, 282, 283, 289, 291, 292, 293, 294, 295, 296, 297, 298, 299, 300, 301, 302, 303, 304, 305, 306, 317, 321, 324]"
SDWebImage,22640,1887,1873,14,"[1, 2, 3, 4, 5, 6, 8, 9, 10, 11, 13, 17, 19, 21, 23, 24, 25, 26, 27, 30, 31, 34, 35, 36, 38, 40, 41, 42, 43, 44, 45, 46, 47, 49, 50, 51, 53, 54, 55, 56, 57, 59, 60, 61, 62, 63, 64, 66, 67, 68, 69, 71, 72, 73, 74, 75, 76, 77, 78, 79, 80, 81, 82, 83, 84, 85, 87, 88, 89, 90, 93, 94, 95, 96, 98, 99, 100, 101, 107, 110, 111, 112, 113, 116, 117, 119, 120, 121, 122, 123, 124, 125, 126, 128, 129, 130, 132, 133, 134, 135]"
tailwindcss,22577,806,724,82,"[1, 12, 13, 14, 15, 16, 18, 19, 23, 26, 27, 30, 31, 32, 34, 42, 43, 45, 47, 48, 49, 51, 52, 53, 55, 56, 57, 58, 59, 61, 63, 67, 73, 74, 75, 78, 80, 86, 87, 92, 93, 94, 98, 101, 102, 103, 105, 106, 107, 108, 111, 112, 118, 121, 122, 125, 129, 130, 134, 136, 137, 144, 146, 147, 148, 150, 153, 155, 156, 157, 159, 161, 162, 172, 175, 177, 178, 179, 182, 184, 185, 189, 190, 191, 192, 193, 195, 197, 198, 199, 201, 204, 208, 210, 212, 215, 217, 218, 219, 220]"
postcss,22559,644,627,17,"[3, 4, 5, 6, 10, 11, 12, 13, 14, 15, 17, 18, 19, 20, 21, 22, 23, 24, 25, 27, 30, 31, 32, 33, 35, 37, 38, 40, 41, 42, 43, 44, 45, 46, 47, 48, 49, 51, 52, 56, 57, 58, 59, 60, 61, 62, 63, 64, 65, 67, 70, 71, 72, 73, 74, 75, 76, 77, 79, 80, 81, 82, 83, 84, 85, 86, 88, 89, 92, 93, 94, 95, 96, 97, 98, 99, 100, 102, 103, 104, 105, 106, 107, 108, 111, 113, 114, 116, 117, 120, 121, 123, 124, 128, 131, 132, 133, 134, 135, 136]"
uppy,22549,1105,1002,103,"[1, 2, 3, 4, 5, 6, 7, 10, 12, 13, 14, 15, 18, 19, 20, 21, 22, 23, 24, 25, 28, 30, 31, 34, 35, 37, 39, 40, 42, 43, 44, 49, 50, 51, 52, 53, 59, 60, 61, 62, 63, 64, 65, 66, 67, 68, 69, 70, 71, 72, 73, 75, 76, 77, 81, 82, 83, 84, 85, 86, 87, 89, 90, 91, 93, 94, 95, 96, 97, 99, 100, 104, 107, 108, 109, 110, 112, 113, 114, 115, 116, 117, 118, 119, 120, 121, 122, 123, 126, 130, 142, 143, 145, 146, 148, 149, 150, 151, 152, 153]"
lerna,22536,1769,1394,375,"[4, 6, 11, 12, 13, 14, 16, 18, 20, 27, 28, 37, 38, 39, 41, 42, 43, 47, 48, 49, 50, 51, 52, 53, 55, 56, 58, 59, 61, 62, 64, 69, 72, 73, 74, 76, 77, 78, 79, 81, 82, 83, 87, 88, 89, 91, 93, 94, 96, 98, 99, 102, 103, 104, 106, 107, 109, 117, 119, 121, 125, 126, 127, 128, 133, 134, 138, 139, 142, 143, 144, 150, 154, 156, 157, 160, 161, 162, 164, 166, 167, 174, 175, 176, 178, 183, 184, 185, 186, 187, 193, 195, 200, 202, 203, 206, 207, 211, 212, 213]"
open-source-mac-os-apps,22482,127,113,14,"[1, 2, 7, 8, 10, 11, 12, 13, 14, 15, 16, 17, 18, 19, 20, 21, 26, 27, 28, 29, 30, 31, 32, 33, 34, 35, 36, 37, 38, 39, 42, 43, 44, 45, 46, 47, 48, 49, 50, 51, 52, 53, 54, 55, 56, 73, 77, 84, 86, 87, 94, 96, 104, 105, 109, 114, 122, 123, 124, 125, 127, 131, 143, 144, 145, 149, 150, 152, 177, 178, 187, 197, 199, 207, 212, 213, 216, 218, 222, 247, 255, 259, 269, 295, 301, 307, 309, 310, 315, 316, 317, 318, 324, 336, 359, 370, 384, 385, 388, 407]"
awesome-react-components,22448,36,36,0,"[9, 12, 14, 16, 17, 27, 29, 30, 31, 36, 37, 40, 42, 46, 55, 57, 58, 60, 62, 67, 74, 76, 79, 80, 82, 83, 86, 90, 103, 108, 123, 139, 154, 158, 169, 216]"
EventBus,22446,520,432,88,"[5, 6, 7, 10, 11, 12, 13, 14, 15, 16, 18, 19, 20, 21, 23, 24, 26, 27, 28, 29, 30, 31, 33, 34, 35, 36, 40, 41, 42, 43, 44, 46, 47, 48, 50, 51, 52, 53, 54, 55, 56, 57, 58, 59, 60, 61, 66, 67, 68, 69, 70, 71, 72, 73, 75, 76, 77, 78, 79, 80, 81, 82, 84, 86, 87, 89, 90, 91, 92, 93, 95, 98, 99, 100, 102, 103, 105, 107, 108, 110, 111, 112, 113, 114, 115, 116, 117, 119, 120, 121, 122, 124, 125, 126, 127, 128, 129, 131, 132, 133]"
gitbook,22363,0,0,0,[]
libpku,22314,32,30,2,"[1, 2, 3, 5, 6, 8, 9, 10, 11, 12, 14, 16, 17, 18, 19, 21, 22, 23, 24, 25, 26, 30, 32, 33, 38, 41, 44, 45, 48, 51, 52, 59]"
alacritty,22312,2482,2123,359,"[1, 2, 3, 4, 5, 6, 7, 8, 9, 10, 11, 12, 13, 14, 15, 16, 17, 18, 19, 20, 21, 22, 23, 24, 25, 26, 28, 29, 30, 31, 32, 33, 34, 35, 36, 37, 38, 39, 40, 41, 42, 43, 44, 45, 46, 47, 48, 50, 51, 52, 53, 54, 55, 57, 58, 61, 62, 63, 64, 65, 68, 69, 70, 71, 72, 73, 75, 76, 77, 78, 79, 80, 81, 82, 83, 85, 87, 88, 89, 90, 93, 94, 95, 97, 98, 99, 100, 101, 102, 103, 104, 105, 106, 107, 108, 109, 110, 111, 112, 113]"
marked,22264,979,903,76,"[1, 2, 3, 4, 6, 8, 9, 10, 11, 12, 13, 14, 15, 16, 17, 18, 19, 20, 21, 22, 23, 25, 26, 27, 29, 32, 33, 34, 36, 37, 38, 40, 43, 44, 45, 46, 47, 49, 50, 51, 52, 53, 54, 55, 56, 57, 58, 59, 60, 61, 62, 63, 65, 67, 69, 72, 73, 75, 76, 77, 78, 79, 81, 82, 84, 85, 86, 89, 90, 91, 92, 93, 94, 99, 101, 102, 103, 104, 105, 106, 107, 109, 110, 111, 112, 113, 115, 116, 119, 120, 121, 122, 123, 124, 128, 132, 133, 135, 136, 137]"
gitlabhq,22235,0,0,0,[]
date-fns,22213,899,750,149,"[2, 3, 4, 5, 6, 7, 8, 9, 10, 11, 12, 13, 14, 15, 16, 17, 19, 32, 33, 34, 38, 66, 72, 73, 74, 75, 76, 77, 78, 80, 81, 82, 83, 86, 88, 89, 90, 92, 96, 97, 99, 104, 105, 106, 107, 116, 126, 127, 128, 132, 133, 136, 137, 138, 144, 147, 149, 157, 159, 166, 167, 168, 170, 172, 173, 174, 175, 176, 177, 178, 179, 180, 182, 184, 188, 189, 190, 192, 197, 199, 200, 203, 204, 208, 213, 214, 216, 218, 219, 220, 221, 222, 223, 226, 227, 228, 229, 230, 232, 234]"
pi-hole,22194,1761,1634,127,"[2, 3, 4, 6, 7, 10, 11, 14, 16, 17, 19, 22, 24, 25, 30, 31, 32, 35, 36, 37, 39, 40, 44, 46, 48, 49, 50, 51, 53, 54, 56, 57, 59, 64, 71, 76, 77, 78, 80, 81, 83, 86, 89, 91, 95, 97, 98, 99, 100, 101, 103, 104, 105, 107, 111, 112, 113, 114, 115, 125, 126, 127, 128, 129, 130, 131, 132, 133, 134, 138, 139, 140, 142, 145, 147, 148, 149, 150, 151, 152, 154, 158, 159, 160, 161, 162, 163, 165, 166, 167, 169, 170, 171, 172, 175, 177, 178, 179, 181, 182]"
chosen,22188,2325,2105,220,"[1, 2, 3, 4, 5, 6, 8, 9, 10, 12, 14, 15, 16, 17, 18, 19, 20, 21, 22, 23, 24, 27, 29, 30, 31, 33, 34, 35, 36, 38, 39, 40, 41, 43, 44, 45, 47, 48, 49, 50, 51, 52, 54, 56, 58, 59, 60, 62, 63, 65, 67, 68, 69, 71, 72, 73, 74, 75, 76, 77, 79, 80, 81, 82, 84, 85, 86, 87, 88, 90, 91, 92, 93, 94, 95, 96, 97, 98, 99, 100, 101, 103, 104, 105, 106, 107, 109, 110, 112, 114, 115, 116, 117, 118, 119, 120, 121, 123, 124, 125]"
jadx,22053,674,555,119,"[1, 4, 6, 8, 9, 10, 12, 13, 15, 18, 20, 21, 22, 24, 25, 26, 27, 28, 31, 32, 33, 38, 40, 41, 42, 43, 45, 46, 47, 48, 50, 51, 52, 53, 54, 55, 56, 58, 59, 60, 61, 62, 65, 66, 67, 68, 69, 70, 71, 72, 73, 74, 75, 77, 78, 79, 80, 82, 84, 85, 86, 87, 88, 89, 90, 91, 92, 94, 95, 97, 98, 99, 101, 102, 104, 105, 106, 107, 109, 110, 111, 112, 113, 116, 117, 118, 120, 121, 122, 123, 124, 125, 126, 127, 129, 130, 131, 132, 133, 134]"
spring-boot-examples,21979,96,94,2,"[1, 2, 3, 4, 7, 8, 9, 10, 11, 12, 13, 14, 15, 16, 17, 18, 19, 21, 30, 31, 32, 33, 34, 35, 38, 39, 40, 41, 43, 44, 45, 46, 47, 49, 50, 51, 54, 55, 56, 57, 58, 59, 60, 64, 65, 66, 67, 68, 69, 70, 71, 72, 73, 75, 76, 77, 78, 79, 80, 82, 84, 85, 86, 88, 90, 91, 92, 94, 95, 96, 97, 98, 100, 102, 103, 105, 106, 107, 108, 109, 111, 112, 113, 114, 116, 117, 118, 119, 121, 123, 124, 126, 127, 128, 132, 133]"
formik,21889,1601,1090,511,"[2, 3, 4, 5, 6, 7, 8, 11, 12, 13, 15, 16, 17, 18, 19, 24, 26, 28, 29, 30, 32, 33, 34, 35, 36, 37, 38, 39, 40, 41, 42, 43, 45, 49, 50, 51, 52, 54, 55, 56, 57, 58, 59, 60, 61, 62, 64, 65, 66, 67, 68, 69, 70, 71, 72, 73, 77, 78, 79, 80, 83, 84, 86, 87, 88, 89, 90, 91, 93, 94, 95, 96, 98, 99, 102, 104, 106, 107, 108, 110, 111, 112, 113, 114, 116, 117, 118, 119, 122, 125, 127, 128, 129, 132, 133, 134, 135, 137, 139, 140]"
cheerio,21858,936,720,216,"[1, 2, 3, 4, 5, 6, 7, 8, 9, 10, 11, 12, 13, 14, 15, 16, 17, 18, 19, 20, 21, 22, 23, 24, 25, 28, 29, 30, 34, 36, 38, 39, 42, 44, 45, 46, 48, 49, 51, 52, 53, 54, 55, 56, 57, 59, 60, 62, 69, 70, 73, 74, 75, 77, 78, 79, 81, 82, 83, 85, 86, 87, 88, 89, 92, 93, 95, 96, 98, 99, 100, 101, 103, 104, 106, 108, 112, 114, 115, 116, 117, 119, 124, 126, 127, 128, 129, 131, 132, 133, 134, 135, 136, 137, 141, 142, 143, 144, 146, 147]"
terraform,21825,14623,13319,1304,"[1, 2, 3, 4, 23, 25, 27, 28, 29, 34, 35, 36, 37, 38, 40, 41, 45, 46, 50, 51, 53, 54, 55, 57, 58, 59, 60, 62, 63, 64, 65, 66, 68, 70, 73, 74, 75, 79, 81, 83, 84, 86, 87, 88, 91, 92, 93, 95, 98, 99, 102, 104, 105, 106, 107, 108, 111, 112, 113, 114, 115, 116, 117, 119, 120, 122, 123, 124, 125, 126, 127, 130, 131, 133, 134, 135, 136, 138, 139, 140, 141, 143, 145, 146, 147, 148, 149, 150, 151, 152, 153, 154, 157, 159, 165, 167, 168, 169, 171, 174]"
rxjs,21805,2550,2230,320,"[1, 2, 3, 4, 5, 6, 9, 10, 12, 14, 17, 18, 19, 20, 21, 22, 23, 24, 25, 28, 29, 30, 31, 34, 57, 58, 59, 60, 61, 62, 63, 64, 65, 66, 69, 70, 71, 72, 73, 75, 76, 77, 78, 79, 80, 81, 82, 83, 84, 85, 90, 91, 93, 95, 96, 99, 100, 101, 104, 108, 109, 110, 111, 112, 113, 114, 115, 116, 117, 121, 122, 126, 127, 128, 129, 130, 131, 132, 133, 135, 139, 141, 145, 150, 151, 153, 156, 159, 161, 165, 167, 171, 172, 174, 175, 177, 178, 179, 180, 184]"
webtorrent,21801,1311,1161,150,"[1, 2, 3, 4, 5, 7, 11, 12, 13, 14, 15, 16, 18, 19, 20, 22, 23, 24, 25, 26, 27, 28, 29, 30, 31, 32, 33, 34, 35, 36, 37, 38, 39, 41, 42, 44, 45, 47, 48, 50, 51, 52, 53, 57, 58, 59, 60, 64, 65, 66, 67, 68, 69, 70, 72, 77, 78, 79, 80, 81, 82, 85, 86, 87, 88, 89, 90, 91, 92, 94, 95, 96, 97, 98, 99, 100, 101, 102, 103, 104, 105, 106, 107, 108, 109, 110, 111, 112, 113, 114, 115, 116, 117, 118, 119, 120, 121, 122, 123, 124]"
sequelize,21800,8559,7756,803,"[5, 8, 9, 10, 11, 12, 13, 14, 15, 16, 17, 18, 19, 20, 21, 22, 23, 24, 25, 26, 28, 29, 30, 31, 32, 33, 34, 35, 36, 38, 39, 40, 41, 42, 43, 46, 48, 49, 50, 51, 52, 53, 54, 55, 64, 66, 67, 68, 71, 73, 74, 78, 79, 80, 81, 82, 83, 86, 87, 88, 89, 90, 91, 93, 94, 95, 96, 97, 99, 100, 101, 103, 104, 105, 114, 115, 116, 118, 119, 120, 123, 126, 127, 129, 131, 133, 135, 136, 138, 139, 140, 142, 143, 145, 147, 148, 149, 151, 152, 156]"
COVID-19,21788,2045,753,1292,"[2, 3, 5, 6, 7, 8, 9, 11, 12, 13, 14, 15, 17, 18, 20, 21, 22, 23, 26, 28, 29, 30, 33, 34, 35, 36, 37, 38, 40, 42, 43, 44, 47, 48, 49, 50, 52, 53, 54, 55, 56, 57, 58, 60, 61, 63, 64, 65, 66, 67, 68, 69, 70, 71, 72, 73, 74, 75, 76, 77, 79, 80, 81, 82, 83, 84, 86, 87, 88, 90, 91, 92, 95, 96, 97, 98, 99, 100, 101, 102, 103, 104, 105, 106, 107, 108, 109, 110, 111, 112, 113, 115, 116, 117, 118, 119, 120, 122, 123, 124]"
mobx,21782,1503,1487,16,"[2, 3, 6, 7, 8, 9, 10, 11, 12, 13, 14, 16, 17, 18, 19, 20, 21, 22, 23, 24, 25, 26, 27, 28, 29, 30, 31, 34, 35, 36, 37, 39, 40, 47, 48, 49, 50, 53, 55, 56, 57, 58, 59, 60, 61, 62, 63, 64, 65, 67, 68, 69, 71, 72, 73, 74, 75, 77, 78, 79, 83, 84, 85, 86, 88, 89, 90, 92, 93, 95, 96, 97, 98, 99, 100, 101, 103, 104, 105, 106, 108, 110, 112, 114, 115, 116, 117, 119, 120, 121, 122, 123, 125, 128, 129, 130, 136, 138, 140, 141]"
manim,21694,570,372,198,"[3, 4, 5, 6, 9, 10, 12, 14, 15, 16, 17, 18, 19, 23, 24, 27, 28, 30, 32, 34, 36, 37, 39, 40, 46, 49, 50, 52, 53, 55, 56, 58, 59, 63, 64, 91, 96, 103, 110, 113, 117, 119, 121, 123, 124, 125, 141, 142, 143, 148, 156, 157, 158, 159, 160, 161, 170, 173, 181, 182, 185, 194, 195, 198, 199, 206, 207, 209, 213, 214, 216, 218, 222, 224, 226, 228, 237, 243, 244, 247, 248, 251, 253, 256, 258, 262, 263, 265, 274, 275, 277, 278, 279, 281, 284, 286, 292, 293, 296, 297]"
minio,21635,4029,3926,103,"[15, 16, 17, 48, 69, 89, 105, 106, 107, 108, 150, 172, 482, 484, 485, 486, 487, 488, 505, 603, 652, 654, 656, 658, 659, 666, 671, 811, 830, 831, 871, 893, 902, 909, 910, 911, 912, 918, 924, 939, 955, 956, 974, 976, 977, 980, 987, 991, 993, 997, 1003, 1005, 1007, 1008, 1009, 1011, 1012, 1018, 1019, 1020, 1023, 1024, 1025, 1027, 1028, 1029, 1033, 1035, 1041, 1043, 1044, 1048, 1049, 1052, 1056, 1058, 1059, 1064, 1066, 1071, 1074, 1076, 1081, 1094, 1098, 1111, 1112, 1116, 1125, 1128, 1130, 1131, 1133, 1134, 1137, 1142, 1146, 1153, 1154, 1156]"
ResumeSample,21601,0,0,0,[]
particles.js,21563,331,71,260,"[1, 8, 9, 15, 18, 19, 22, 23, 27, 30, 32, 33, 34, 37, 42, 44, 47, 48, 49, 50, 54, 55, 56, 57, 59, 61, 62, 63, 64, 67, 68, 69, 71, 72, 73, 78, 80, 82, 83, 84, 85, 86, 87, 88, 90, 91, 92, 95, 96, 98, 101, 102, 103, 104, 106, 107, 109, 110, 111, 112, 113, 114, 115, 116, 117, 118, 119, 120, 121, 122, 123, 124, 125, 126, 127, 128, 129, 130, 131, 132, 133, 136, 137, 138, 141, 142, 143, 145, 146, 147, 148, 150, 152, 154, 155, 156, 157, 158, 159, 160]"
layui,21535,482,75,407,"[18, 20, 21, 22, 24, 25, 26, 27, 28, 29, 30, 31, 32, 33, 34, 35, 36, 37, 38, 39, 40, 41, 42, 43, 95, 96, 97, 98, 99, 101, 103, 104, 105, 106, 107, 110, 111, 112, 113, 114, 115, 116, 117, 119, 124, 126, 127, 128, 129, 130, 131, 133, 134, 135, 138, 139, 141, 142, 143, 144, 145, 148, 149, 150, 151, 152, 153, 154, 155, 156, 157, 158, 159, 160, 161, 162, 163, 164, 166, 167, 168, 169, 171, 172, 173, 175, 176, 177, 178, 179, 180, 181, 182, 183, 184, 185, 186, 188, 189, 190]"
ace,21454,2491,1834,657,"[1, 2, 3, 4, 5, 7, 8, 10, 12, 13, 16, 17, 26, 27, 30, 31, 32, 33, 34, 35, 36, 37, 38, 39, 40, 41, 42, 43, 44, 45, 49, 50, 54, 55, 56, 57, 59, 62, 72, 73, 74, 75, 76, 77, 78, 80, 81, 82, 83, 85, 86, 89, 91, 93, 100, 101, 102, 104, 107, 108, 109, 110, 111, 114, 116, 117, 118, 119, 120, 121, 123, 125, 126, 137, 139, 140, 141, 142, 147, 148, 150, 158, 161, 163, 164, 165, 167, 168, 169, 170, 173, 174, 175, 176, 177, 178, 179, 181, 182, 183]"
ember.js,21451,6242,5993,249,"[1, 2, 4, 6, 7, 12, 14, 16, 20, 22, 27, 30, 36, 37, 38, 39, 40, 41, 43, 49, 54, 55, 56, 57, 59, 60, 61, 66, 67, 68, 69, 75, 78, 81, 84, 85, 86, 87, 88, 89, 91, 93, 97, 100, 102, 103, 105, 107, 108, 110, 112, 115, 116, 117, 118, 120, 122, 123, 124, 125, 126, 127, 128, 129, 130, 131, 132, 133, 136, 139, 144, 145, 146, 147, 148, 149, 150, 151, 152, 153, 155, 158, 159, 160, 161, 164, 167, 170, 171, 176, 178, 179, 182, 183, 184, 185, 192, 195, 197, 199]"
brew,21449,2492,2477,15,"[6, 9, 11, 13, 16, 20, 21, 22, 26, 29, 30, 38, 41, 42, 43, 44, 45, 47, 48, 51, 52, 54, 55, 58, 60, 61, 62, 64, 65, 69, 72, 73, 81, 82, 83, 87, 88, 89, 90, 91, 93, 94, 95, 97, 100, 104, 105, 106, 108, 117, 126, 134, 137, 139, 140, 142, 144, 145, 147, 148, 152, 158, 159, 160, 169, 170, 185, 186, 187, 193, 200, 203, 204, 206, 207, 209, 210, 211, 214, 215, 216, 218, 219, 220, 224, 226, 227, 228, 229, 230, 234, 235, 236, 238, 239, 240, 243, 245, 246, 247]"
vimrc,21448,404,389,15,"[1, 2, 3, 4, 5, 7, 8, 9, 10, 11, 12, 13, 14, 16, 17, 18, 19, 20, 21, 22, 23, 25, 27, 29, 33, 34, 35, 36, 37, 38, 40, 42, 44, 46, 47, 48, 49, 51, 52, 53, 54, 55, 56, 57, 58, 59, 61, 62, 63, 65, 67, 68, 69, 70, 71, 72, 73, 74, 75, 76, 77, 78, 79, 80, 81, 83, 84, 85, 88, 92, 93, 95, 96, 98, 99, 102, 103, 108, 109, 111, 112, 113, 118, 119, 120, 128, 129, 130, 132, 135, 139, 140, 141, 142, 143, 144, 145, 147, 149, 150]"
p3c,21432,588,517,71,"[1, 2, 4, 5, 6, 7, 8, 9, 10, 11, 12, 13, 14, 15, 16, 17, 18, 19, 20, 21, 22, 23, 24, 25, 26, 27, 28, 29, 30, 31, 32, 33, 34, 35, 36, 38, 39, 40, 42, 43, 44, 46, 47, 48, 49, 50, 51, 52, 53, 54, 55, 56, 57, 58, 59, 60, 61, 62, 64, 65, 66, 67, 68, 69, 71, 72, 73, 74, 75, 76, 77, 78, 80, 81, 82, 83, 84, 85, 86, 88, 89, 90, 91, 92, 93, 94, 95, 96, 97, 98, 100, 101, 102, 103, 104, 105, 107, 108, 109, 110]"
tesseract.js,21416,354,341,13,"[1, 2, 3, 4, 5, 6, 7, 8, 9, 10, 11, 16, 17, 18, 19, 23, 28, 29, 30, 31, 32, 33, 35, 38, 40, 42, 43, 45, 48, 50, 51, 52, 53, 54, 55, 56, 57, 58, 59, 60, 61, 62, 63, 64, 65, 66, 67, 68, 69, 71, 72, 75, 77, 78, 80, 81, 82, 83, 84, 85, 86, 87, 88, 89, 90, 91, 92, 93, 95, 96, 97, 99, 100, 101, 102, 103, 104, 105, 106, 107, 108, 109, 110, 111, 112, 113, 114, 115, 116, 117, 119, 120, 121, 122, 123, 124, 125, 126, 127, 128]"
polymer,21406,3884,3638,246,"[7, 10, 11, 15, 18, 24, 30, 41, 43, 56, 62, 64, 65, 66, 67, 68, 69, 70, 71, 72, 73, 74, 77, 78, 79, 80, 81, 83, 86, 87, 89, 90, 91, 92, 93, 94, 95, 96, 97, 98, 100, 101, 102, 103, 104, 105, 106, 107, 108, 109, 110, 111, 114, 115, 116, 117, 118, 119, 120, 121, 123, 124, 127, 128, 129, 131, 132, 133, 136, 137, 138, 139, 140, 141, 142, 145, 146, 147, 148, 149, 150, 151, 152, 153, 154, 155, 156, 157, 159, 160, 161, 162, 163, 165, 166, 167, 169, 170, 171, 173]"
rclone,21339,3208,2528,680,"[1, 2, 3, 4, 5, 6, 7, 8, 9, 10, 11, 12, 13, 14, 15, 16, 17, 18, 19, 20, 21, 22, 23, 24, 25, 26, 27, 28, 29, 30, 31, 32, 33, 34, 35, 36, 37, 38, 39, 40, 41, 42, 43, 44, 45, 46, 47, 48, 49, 50, 51, 52, 53, 54, 55, 56, 59, 60, 61, 62, 63, 64, 66, 67, 69, 70, 73, 75, 76, 77, 78, 79, 80, 81, 82, 84, 85, 86, 87, 88, 89, 90, 95, 96, 97, 98, 99, 100, 101, 102, 103, 104, 105, 106, 107, 108, 109, 110, 111, 112]"
sails,21308,6119,5766,353,"[1, 2, 3, 4, 5, 6, 7, 8, 9, 10, 11, 12, 13, 14, 15, 16, 17, 18, 19, 20, 21, 22, 23, 24, 25, 26, 27, 28, 29, 30, 31, 32, 33, 34, 35, 36, 37, 40, 41, 42, 43, 44, 45, 47, 48, 49, 51, 52, 53, 54, 55, 56, 57, 58, 59, 60, 61, 62, 63, 64, 65, 66, 67, 68, 69, 71, 72, 73, 74, 75, 78, 79, 80, 81, 82, 83, 84, 85, 86, 87, 88, 89, 90, 91, 92, 93, 94, 95, 96, 97, 98, 99, 100, 101, 102, 103, 104, 105, 106, 112]"
the-way-to-go_ZH_CN,21277,0,0,0,[]
fastjson,21273,2618,1333,1285,"[1, 2, 3, 4, 5, 6, 7, 10, 11, 12, 13, 14, 15, 16, 17, 18, 19, 20, 22, 23, 24, 25, 27, 28, 30, 32, 33, 34, 35, 36, 37, 38, 39, 40, 42, 43, 44, 45, 46, 47, 49, 50, 51, 52, 53, 54, 55, 56, 57, 58, 59, 60, 61, 62, 63, 64, 65, 66, 68, 69, 70, 71, 72, 73, 74, 76, 77, 78, 79, 80, 82, 83, 84, 85, 86, 87, 88, 89, 91, 92, 93, 94, 95, 96, 99, 101, 103, 104, 105, 107, 109, 110, 111, 112, 113, 115, 116, 117, 118, 119]"
hammer.js,21272,1004,753,251,"[1, 2, 8, 9, 10, 11, 12, 13, 14, 15, 16, 17, 18, 19, 20, 21, 22, 23, 24, 25, 26, 27, 28, 30, 31, 32, 33, 34, 36, 37, 39, 40, 41, 42, 44, 45, 46, 48, 49, 50, 51, 52, 53, 54, 55, 56, 57, 58, 59, 60, 61, 62, 63, 64, 65, 66, 67, 68, 69, 70, 71, 73, 74, 75, 76, 78, 79, 80, 81, 82, 84, 85, 87, 91, 92, 93, 97, 99, 100, 101, 102, 104, 106, 107, 108, 109, 110, 111, 113, 115, 116, 118, 119, 120, 121, 123, 124, 125, 126, 127]"
Vundle.vim,21233,683,531,152,"[1, 2, 3, 5, 6, 7, 9, 11, 12, 13, 14, 15, 16, 17, 18, 19, 20, 21, 22, 23, 24, 26, 27, 28, 30, 31, 35, 37, 38, 39, 44, 45, 46, 47, 48, 50, 51, 52, 54, 56, 57, 59, 60, 61, 62, 64, 65, 66, 67, 68, 69, 70, 74, 76, 77, 78, 79, 80, 81, 82, 83, 84, 85, 87, 88, 89, 90, 92, 94, 96, 99, 102, 103, 104, 105, 108, 110, 111, 112, 113, 114, 115, 117, 119, 120, 121, 122, 123, 124, 125, 127, 131, 132, 135, 136, 137, 139, 140, 141, 142]"
project-guidelines,21217,36,24,12,"[5, 10, 19, 20, 25, 27, 30, 32, 40, 45, 51, 58, 68, 74, 80, 82, 84, 87, 88, 89, 90, 97, 108, 109, 111, 115, 116, 124, 125, 131, 133, 134, 138, 139, 140, 146]"
linux-insides,21147,154,120,34,"[8, 29, 30, 37, 42, 45, 52, 53, 55, 57, 70, 80, 88, 90, 108, 115, 118, 120, 124, 139, 144, 147, 155, 156, 169, 175, 181, 185, 196, 197, 200, 202, 211, 220, 230, 237, 263, 274, 275, 278, 303, 306, 307, 312, 329, 332, 341, 345, 353, 354, 369, 379, 384, 392, 398, 406, 419, 421, 423, 424, 428, 432, 433, 441, 442, 443, 445, 446, 448, 457, 458, 464, 467, 470, 472, 477, 478, 479, 480, 485, 487, 493, 494, 496, 498, 502, 516, 528, 529, 530, 536, 541, 543, 544, 545, 546, 547, 549, 553, 555]"
nerd-fonts,21127,343,224,119,"[1, 2, 3, 4, 6, 7, 8, 9, 10, 11, 12, 13, 14, 15, 16, 17, 19, 22, 23, 24, 25, 26, 29, 30, 31, 32, 33, 34, 35, 37, 38, 39, 40, 41, 42, 43, 44, 45, 46, 48, 49, 50, 52, 53, 54, 55, 56, 57, 58, 59, 60, 63, 64, 65, 66, 67, 68, 69, 70, 72, 73, 74, 75, 76, 77, 78, 79, 80, 81, 83, 84, 85, 86, 87, 88, 89, 90, 92, 93, 94, 95, 96, 97, 99, 100, 102, 104, 105, 106, 108, 109, 111, 112, 114, 115, 116, 117, 118, 119, 120]"
tabler,21127,308,258,50,"[3, 7, 8, 9, 10, 11, 12, 13, 16, 18, 19, 20, 21, 23, 24, 26, 30, 31, 32, 34, 35, 37, 42, 47, 48, 49, 51, 53, 55, 56, 59, 60, 64, 65, 67, 68, 69, 70, 71, 72, 75, 77, 78, 79, 80, 83, 84, 85, 86, 87, 88, 89, 90, 91, 92, 93, 94, 95, 96, 97, 98, 99, 100, 101, 103, 104, 105, 106, 108, 109, 110, 111, 112, 114, 115, 117, 118, 120, 122, 123, 124, 125, 127, 128, 129, 130, 131, 133, 134, 137, 138, 139, 140, 141, 142, 143, 146, 147, 148, 149]"
YouCompleteMe,21114,2845,2818,27,"[1, 2, 3, 6, 7, 8, 9, 10, 11, 12, 15, 16, 17, 18, 19, 20, 21, 22, 24, 25, 27, 28, 30, 31, 32, 33, 34, 35, 36, 37, 39, 40, 41, 42, 43, 44, 45, 46, 47, 48, 49, 50, 51, 52, 53, 54, 55, 57, 58, 60, 61, 62, 64, 65, 66, 67, 68, 69, 70, 71, 72, 73, 74, 75, 76, 77, 78, 79, 81, 82, 83, 84, 85, 86, 87, 88, 89, 91, 94, 95, 96, 97, 98, 99, 100, 101, 102, 103, 104, 105, 106, 107, 108, 109, 111, 112, 114, 118, 120, 121]"
druid,21086,2755,1070,1685,"[5, 6, 7, 8, 11, 24, 26, 141, 142, 143, 144, 146, 147, 156, 160, 172, 175, 176, 177, 182, 183, 185, 196, 221, 222, 225, 226, 245, 261, 268, 273, 274, 275, 276, 277, 279, 283, 285, 288, 291, 303, 304, 306, 308, 310, 312, 314, 316, 329, 330, 333, 334, 335, 339, 340, 341, 343, 351, 352, 357, 360, 361, 363, 370, 371, 373, 376, 383, 388, 389, 390, 392, 393, 395, 396, 397, 398, 399, 400, 401, 402, 403, 406, 407, 414, 416, 417, 422, 424, 425, 426, 427, 428, 429, 430, 431, 434, 436, 438, 442]"
Probabilistic-Programming-and-Bayesian-Methods-for-Hackers,21080,210,82,128,"[5, 8, 11, 12, 13, 18, 19, 21, 22, 23, 24, 26, 28, 29, 30, 34, 36, 38, 42, 43, 49, 50, 51, 52, 59, 63, 64, 68, 69, 71, 72, 75, 77, 78, 79, 81, 83, 84, 87, 88, 91, 99, 104, 107, 112, 118, 124, 128, 129, 139, 142, 143, 144, 145, 146, 147, 150, 155, 161, 164, 165, 166, 167, 169, 172, 176, 179, 188, 189, 194, 195, 196, 203, 204, 208, 210, 212, 215, 216, 219, 221, 224, 225, 227, 228, 229, 232, 233, 234, 235, 238, 241, 242, 245, 246, 247, 252, 253, 254, 255]"
fastText,21046,855,567,288,"[1, 5, 7, 9, 10, 11, 12, 16, 17, 20, 21, 23, 24, 25, 26, 30, 33, 36, 38, 40, 42, 46, 48, 52, 53, 56, 58, 59, 60, 61, 62, 63, 64, 66, 67, 68, 71, 72, 73, 74, 75, 76, 77, 78, 79, 81, 82, 83, 85, 87, 89, 90, 91, 92, 93, 94, 96, 97, 98, 100, 101, 102, 103, 104, 107, 108, 110, 111, 112, 113, 114, 115, 116, 117, 119, 120, 121, 122, 123, 124, 125, 126, 127, 128, 129, 130, 131, 133, 135, 136, 138, 139, 141, 144, 145, 147, 150, 151, 152, 153]"
kubernetes-the-hard-way,21041,294,266,28,"[2, 3, 6, 7, 8, 9, 10, 11, 12, 14, 15, 16, 18, 21, 23, 24, 25, 26, 27, 30, 31, 32, 33, 34, 36, 37, 39, 40, 41, 42, 43, 45, 47, 52, 53, 56, 58, 59, 62, 66, 68, 70, 71, 72, 74, 75, 78, 80, 81, 85, 86, 88, 91, 92, 95, 98, 100, 102, 104, 105, 106, 107, 108, 109, 111, 114, 116, 119, 120, 124, 126, 127, 128, 129, 131, 136, 140, 141, 143, 144, 145, 146, 148, 149, 151, 153, 156, 157, 158, 159, 160, 161, 162, 164, 167, 168, 169, 171, 172, 173]"
awesome-deep-learning-papers,21025,23,11,12,"[1, 9, 20, 21, 23, 29, 30, 32, 33, 36, 44, 48, 51, 56, 59, 65, 70, 78, 82, 84, 85, 87, 90]"
streisand,21014,1092,922,170,"[1, 2, 3, 4, 5, 6, 7, 8, 9, 11, 12, 14, 16, 17, 18, 19, 23, 24, 25, 26, 29, 30, 31, 33, 35, 36, 37, 38, 39, 40, 41, 43, 44, 45, 46, 47, 48, 49, 50, 51, 52, 54, 55, 56, 57, 58, 60, 61, 62, 63, 64, 65, 68, 72, 73, 74, 76, 77, 78, 80, 81, 82, 84, 85, 86, 87, 88, 89, 90, 91, 92, 93, 95, 96, 97, 98, 99, 100, 101, 103, 104, 105, 106, 108, 109, 110, 111, 112, 113, 114, 115, 117, 118, 119, 120, 121, 122, 123, 124, 125]"
framework,21001,13595,13588,7,"[1, 3, 5, 6, 8, 9, 10, 11, 12, 15, 16, 17, 21, 22, 23, 24, 25, 26, 27, 28, 29, 31, 32, 33, 34, 35, 36, 37, 38, 39, 41, 42, 43, 44, 45, 46, 47, 48, 49, 50, 51, 52, 53, 55, 56, 57, 58, 59, 63, 64, 65, 66, 67, 68, 69, 75, 76, 78, 79, 81, 82, 83, 84, 85, 86, 87, 88, 89, 91, 92, 93, 94, 95, 96, 99, 102, 104, 105, 106, 107, 109, 110, 112, 116, 117, 119, 120, 121, 125, 126, 128, 130, 131, 132, 134, 136, 137, 138, 139, 140]"
drone,20973,1704,1674,30,"[1, 2, 3, 4, 5, 6, 8, 10, 11, 13, 15, 17, 20, 21, 24, 25, 27, 31, 32, 37, 41, 42, 43, 44, 45, 47, 50, 51, 53, 54, 55, 61, 63, 64, 66, 70, 81, 84, 85, 86, 89, 90, 91, 92, 93, 94, 95, 96, 97, 100, 102, 105, 106, 107, 108, 109, 110, 111, 112, 114, 117, 118, 119, 120, 122, 126, 132, 135, 136, 137, 140, 141, 142, 143, 144, 145, 147, 148, 149, 152, 156, 157, 159, 162, 166, 168, 169, 173, 174, 176, 177, 178, 180, 181, 185, 187, 188, 190, 192, 193]"
uni-app,20887,1508,1030,478,"[1, 2, 3, 4, 5, 6, 7, 8, 9, 10, 11, 12, 13, 14, 15, 16, 17, 18, 19, 20, 21, 22, 23, 24, 29, 31, 33, 34, 37, 38, 39, 40, 41, 42, 43, 44, 45, 46, 47, 49, 53, 55, 56, 58, 60, 61, 62, 63, 64, 65, 66, 67, 68, 69, 70, 71, 72, 73, 74, 76, 77, 78, 79, 81, 82, 83, 85, 86, 87, 88, 89, 90, 91, 92, 93, 94, 95, 96, 97, 98, 99, 100, 101, 102, 103, 104, 105, 106, 107, 108, 109, 110, 111, 112, 113, 114, 115, 116, 117, 118]"
sheetjs,20884,1688,1353,335,"[2, 3, 4, 6, 7, 8, 9, 10, 11, 13, 14, 15, 17, 18, 19, 20, 21, 22, 23, 24, 25, 27, 29, 30, 31, 33, 34, 35, 36, 37, 38, 40, 41, 42, 44, 45, 47, 49, 50, 51, 52, 53, 55, 56, 57, 59, 60, 61, 62, 63, 64, 65, 68, 70, 71, 72, 73, 74, 75, 76, 77, 78, 79, 80, 81, 82, 83, 84, 85, 87, 88, 90, 91, 92, 93, 94, 95, 96, 97, 98, 99, 100, 101, 102, 104, 105, 106, 107, 108, 109, 110, 111, 113, 114, 115, 117, 118, 119, 120, 121]"
nprogress,20872,133,46,87,"[1, 2, 4, 5, 7, 8, 11, 12, 13, 15, 17, 22, 23, 25, 26, 29, 31, 32, 35, 38, 39, 40, 41, 42, 43, 44, 46, 48, 49, 50, 55, 56, 57, 58, 60, 61, 67, 68, 70, 71, 72, 74, 79, 81, 82, 84, 85, 87, 88, 91, 94, 95, 97, 98, 100, 103, 104, 105, 106, 113, 114, 115, 116, 117, 118, 121, 123, 124, 125, 126, 130, 131, 134, 135, 137, 138, 139, 140, 141, 144, 147, 149, 150, 151, 152, 153, 154, 158, 159, 162, 163, 165, 166, 168, 169, 171, 172, 173, 174, 175]"
arthas,20863,868,755,113,"[1, 2, 3, 4, 5, 6, 7, 8, 9, 10, 11, 12, 13, 14, 15, 16, 17, 19, 20, 21, 22, 23, 24, 25, 26, 27, 28, 29, 30, 31, 32, 33, 34, 35, 36, 37, 38, 39, 40, 41, 42, 43, 44, 45, 46, 47, 51, 52, 53, 54, 55, 56, 58, 59, 60, 61, 62, 63, 67, 69, 70, 71, 72, 73, 74, 76, 79, 80, 81, 82, 83, 84, 85, 86, 87, 89, 90, 91, 92, 93, 94, 96, 97, 98, 100, 101, 102, 111, 112, 113, 118, 119, 128, 130, 131, 132, 133, 134, 135, 137]"
mastodon,20853,5428,3897,1531,"[1, 2, 3, 4, 5, 6, 7, 8, 9, 10, 11, 12, 13, 14, 15, 16, 17, 18, 19, 20, 21, 22, 23, 24, 25, 26, 27, 28, 29, 30, 31, 32, 33, 34, 35, 36, 37, 38, 39, 40, 41, 42, 43, 44, 45, 46, 47, 48, 49, 50, 51, 52, 53, 54, 55, 56, 57, 58, 59, 60, 61, 62, 63, 64, 65, 66, 67, 68, 70, 71, 72, 73, 76, 77, 78, 79, 80, 81, 82, 83, 84, 85, 86, 88, 90, 93, 94, 95, 96, 97, 98, 99, 100, 102, 103, 104, 105, 106, 107, 108]"
flutter-go,20836,323,173,150,"[1, 2, 4, 5, 7, 10, 11, 12, 13, 14, 15, 19, 20, 22, 24, 29, 30, 31, 33, 35, 40, 41, 48, 51, 52, 55, 59, 61, 65, 66, 67, 68, 71, 83, 84, 86, 87, 88, 89, 94, 101, 102, 105, 107, 108, 125, 126, 127, 128, 129, 130, 131, 134, 144, 150, 153, 155, 156, 157, 158, 159, 160, 161, 162, 163, 164, 166, 167, 168, 169, 170, 171, 172, 174, 175, 176, 177, 178, 179, 182, 183, 184, 185, 187, 193, 195, 196, 197, 198, 200, 202, 203, 204, 207, 208, 209, 210, 212, 213, 217]"
python-guide,20791,246,151,95,"[13, 40, 44, 48, 61, 71, 85, 86, 87, 88, 91, 93, 94, 97, 103, 111, 113, 123, 124, 126, 132, 143, 145, 150, 159, 161, 164, 167, 170, 174, 186, 189, 192, 193, 200, 208, 234, 236, 238, 241, 245, 254, 263, 268, 270, 289, 291, 298, 299, 314, 316, 317, 320, 322, 324, 325, 326, 327, 328, 329, 335, 336, 341, 342, 356, 359, 361, 373, 381, 382, 395, 397, 413, 424, 429, 433, 436, 437, 439, 445, 451, 452, 453, 454, 457, 463, 468, 469, 470, 472, 481, 482, 483, 484, 489, 490, 492, 494, 499, 514]"
pure,20788,526,509,17,"[1, 4, 9, 10, 11, 14, 15, 19, 20, 21, 22, 23, 24, 25, 26, 27, 28, 29, 30, 31, 33, 34, 35, 36, 37, 39, 40, 41, 42, 44, 45, 47, 48, 49, 52, 53, 54, 55, 56, 57, 58, 60, 62, 66, 68, 71, 72, 73, 75, 77, 78, 84, 85, 87, 88, 89, 90, 92, 93, 94, 95, 97, 98, 100, 103, 104, 105, 106, 107, 108, 109, 111, 113, 114, 116, 117, 118, 119, 122, 123, 124, 125, 126, 127, 129, 130, 136, 140, 141, 143, 151, 152, 153, 154, 156, 158, 159, 161, 162, 163]"
cmder,20781,1860,1850,10,"[1, 2, 3, 4, 6, 8, 9, 10, 11, 12, 13, 14, 16, 17, 19, 21, 23, 25, 27, 28, 35, 37, 38, 39, 40, 41, 42, 43, 44, 45, 46, 47, 48, 49, 50, 52, 54, 55, 57, 58, 59, 61, 64, 66, 67, 68, 69, 71, 72, 76, 79, 80, 81, 83, 84, 86, 87, 89, 90, 91, 92, 93, 94, 95, 96, 97, 99, 100, 101, 102, 103, 104, 105, 107, 108, 109, 110, 112, 113, 114, 115, 117, 118, 119, 120, 121, 122, 123, 124, 126, 127, 128, 129, 130, 132, 133, 134, 136, 137, 138]"
devise,20774,3936,3884,52,"[1, 2, 3, 4, 5, 6, 7, 8, 9, 10, 11, 12, 13, 14, 15, 16, 17, 18, 19, 20, 21, 22, 23, 24, 25, 26, 27, 28, 29, 30, 31, 32, 33, 34, 35, 36, 37, 38, 39, 40, 41, 42, 43, 44, 45, 46, 47, 48, 49, 50, 51, 52, 53, 54, 55, 56, 57, 58, 59, 60, 61, 62, 63, 64, 65, 66, 67, 68, 69, 70, 71, 72, 73, 74, 75, 76, 77, 78, 79, 80, 81, 82, 83, 84, 85, 86, 87, 88, 89, 90, 91, 92, 93, 94, 95, 96, 97, 98, 99, 100]"
tutorials,20721,373,361,12,"[2, 3, 188, 189, 193, 211, 216, 229, 247, 248, 250, 251, 254, 255, 261, 262, 263, 265, 266, 271, 272, 281, 284, 287, 295, 296, 325, 327, 329, 330, 331, 333, 346, 348, 374, 375, 379, 382, 383, 393, 508, 544, 644, 670, 682, 733, 745, 883, 950, 959, 1009, 1142, 1490, 1512, 1638, 1716, 1753, 1779, 1882, 1945, 2059, 2066, 2200, 2239, 2279, 2281, 2360, 2414, 2431, 2520, 2623, 2673, 2680, 2687, 2699, 2704, 2712, 2751, 2849, 2876, 2913, 2925, 2931, 2938, 2939, 2995, 3025, 3034, 3073, 3093, 3097, 3115, 3147, 3158, 3209, 3213, 3234, 3248, 3250, 3289]"
mongoose,20714,7385,7060,325,"[1, 2, 3, 4, 5, 6, 7, 8, 9, 10, 11, 12, 13, 14, 15, 16, 17, 18, 19, 20, 21, 22, 23, 24, 25, 26, 27, 28, 29, 30, 31, 32, 33, 34, 35, 36, 37, 38, 39, 40, 41, 42, 43, 44, 45, 46, 47, 48, 50, 51, 52, 53, 54, 55, 56, 57, 58, 59, 60, 61, 62, 63, 65, 66, 67, 71, 72, 73, 74, 75, 76, 77, 78, 79, 80, 83, 84, 85, 86, 88, 89, 90, 91, 92, 93, 94, 95, 96, 97, 98, 99, 100, 101, 102, 103, 104, 105, 106, 107, 108]"
sweetalert,20700,657,535,122,"[4, 5, 9, 10, 12, 19, 21, 22, 23, 24, 25, 26, 27, 28, 30, 34, 35, 37, 38, 42, 44, 45, 48, 49, 52, 53, 54, 57, 58, 59, 61, 62, 63, 64, 65, 66, 67, 68, 69, 70, 72, 73, 74, 76, 77, 78, 79, 81, 82, 84, 87, 88, 89, 91, 96, 101, 103, 104, 105, 109, 111, 112, 114, 115, 116, 118, 119, 122, 123, 124, 126, 127, 128, 130, 131, 133, 136, 144, 145, 147, 148, 151, 152, 153, 155, 156, 159, 160, 166, 167, 168, 169, 174, 175, 176, 177, 178, 179, 180, 181]"
blog,20674,40,29,11,"[1, 2, 3, 4, 5, 6, 7, 8, 9, 10, 11, 12, 13, 15, 16, 17, 18, 19, 20, 21, 22, 23, 24, 25, 26, 27, 28, 29, 30, 31, 32, 35, 38, 39, 40, 41, 42, 43, 45, 47]"
ghidra,20674,1479,831,648,"[1, 2, 3, 6, 7, 8, 10, 11, 12, 13, 15, 16, 17, 18, 19, 20, 21, 22, 23, 24, 25, 26, 27, 28, 29, 30, 31, 32, 33, 35, 36, 37, 38, 39, 40, 41, 43, 44, 45, 46, 47, 49, 51, 52, 53, 54, 55, 56, 59, 60, 61, 63, 64, 65, 66, 67, 68, 71, 72, 73, 74, 75, 76, 77, 78, 79, 80, 81, 82, 83, 84, 85, 87, 88, 90, 91, 92, 93, 94, 95, 96, 97, 98, 99, 100, 101, 102, 103, 104, 105, 106, 107, 108, 109, 110, 111, 113, 114, 115, 116]"
lottie-web,20672,2017,1515,502,"[1, 2, 3, 4, 5, 6, 7, 8, 9, 10, 11, 12, 13, 14, 16, 17, 18, 20, 21, 22, 23, 24, 25, 26, 27, 28, 30, 31, 32, 33, 34, 35, 36, 37, 38, 39, 40, 41, 42, 43, 44, 45, 46, 47, 48, 49, 50, 51, 52, 53, 54, 55, 56, 57, 58, 59, 60, 61, 62, 63, 65, 66, 67, 68, 69, 70, 71, 72, 73, 74, 75, 76, 77, 78, 79, 80, 81, 82, 83, 84, 85, 86, 87, 88, 89, 90, 91, 92, 93, 94, 95, 96, 97, 98, 99, 100, 101, 102, 103, 104]"
Motrix,20663,532,293,239,"[2, 4, 5, 6, 7, 8, 9, 11, 12, 13, 14, 15, 18, 19, 20, 21, 22, 23, 24, 25, 26, 27, 28, 29, 30, 31, 32, 33, 34, 35, 36, 37, 38, 39, 40, 41, 42, 43, 44, 46, 47, 48, 49, 50, 51, 52, 53, 54, 55, 56, 58, 61, 62, 64, 65, 66, 69, 71, 74, 75, 76, 77, 78, 79, 80, 81, 82, 83, 84, 85, 86, 87, 88, 89, 90, 91, 92, 94, 95, 96, 98, 99, 102, 104, 105, 106, 107, 109, 110, 112, 113, 114, 115, 116, 118, 119, 120, 121, 122, 125]"
wtfpython,20607,107,81,26,"[1, 2, 3, 4, 9, 10, 11, 13, 16, 17, 18, 22, 23, 26, 30, 32, 35, 36, 38, 39, 40, 41, 43, 49, 51, 52, 53, 54, 57, 62, 63, 66, 67, 68, 69, 70, 73, 74, 77, 78, 80, 81, 83, 84, 85, 87, 90, 93, 94, 96, 98, 100, 101, 103, 106, 108, 110, 111, 112, 113, 114, 115, 116, 117, 118, 119, 120, 121, 123, 128, 130, 132, 133, 135, 136, 137, 140, 142, 143, 145, 147, 148, 149, 150, 151, 153, 156, 161, 162, 163, 164, 165, 172, 173, 179, 180, 182, 184, 191, 193]"
SmartRefreshLayout,20602,1126,1045,81,"[1, 2, 3, 4, 5, 6, 7, 8, 9, 10, 11, 12, 13, 14, 15, 16, 17, 18, 19, 20, 21, 22, 23, 24, 25, 26, 27, 28, 29, 30, 31, 32, 33, 34, 35, 36, 37, 38, 39, 40, 41, 42, 43, 44, 45, 46, 47, 48, 49, 50, 51, 52, 53, 54, 55, 56, 57, 58, 59, 60, 61, 62, 63, 64, 65, 66, 68, 69, 70, 71, 72, 73, 74, 75, 77, 78, 79, 80, 81, 82, 83, 84, 85, 86, 87, 88, 89, 90, 91, 92, 93, 94, 95, 96, 97, 98, 99, 101, 102, 103]"
apollo,20592,1991,1830,161,"[406, 419, 432, 434, 439, 440, 442, 445, 448, 451, 459, 462, 481, 483, 487, 512, 513, 514, 515, 551, 556, 562, 566, 568, 569, 572, 573, 574, 576, 577, 580, 581, 582, 583, 584, 585, 586, 587, 588, 590, 591, 593, 602, 610, 611, 613, 614, 615, 616, 619, 620, 621, 622, 623, 624, 626, 628, 629, 630, 632, 633, 634, 635, 643, 644, 646, 647, 649, 650, 651, 652, 653, 654, 655, 656, 657, 660, 661, 662, 663, 664, 665, 666, 667, 670, 671, 675, 679, 680, 681, 682, 683, 684, 685, 690, 692, 693, 694, 695, 699]"
flow,20585,6288,3871,2417,"[2, 3, 4, 5, 6, 7, 8, 11, 13, 14, 15, 16, 17, 18, 19, 20, 21, 22, 23, 24, 25, 26, 28, 29, 30, 31, 32, 34, 35, 36, 37, 38, 40, 41, 42, 43, 45, 46, 47, 48, 49, 51, 52, 54, 56, 57, 58, 60, 61, 62, 64, 67, 69, 70, 71, 72, 73, 74, 76, 79, 83, 84, 85, 86, 87, 88, 89, 90, 91, 92, 93, 95, 96, 97, 99, 100, 101, 102, 103, 105, 106, 107, 109, 110, 111, 112, 114, 116, 117, 118, 119, 120, 121, 122, 123, 124, 125, 126, 127, 128]"
leveldb,20566,573,469,104,"[7, 8, 9, 10, 11, 12, 13, 14, 15, 16, 17, 18, 19, 20, 21, 22, 23, 24, 25, 26, 27, 28, 29, 30, 31, 32, 33, 34, 35, 36, 37, 38, 39, 40, 41, 42, 43, 44, 45, 46, 47, 48, 49, 50, 51, 52, 53, 54, 55, 56, 57, 58, 59, 60, 61, 62, 63, 64, 65, 66, 67, 68, 69, 70, 71, 72, 73, 74, 75, 76, 77, 78, 79, 80, 81, 82, 83, 84, 85, 86, 87, 88, 89, 90, 91, 92, 93, 94, 95, 96, 97, 98, 99, 100, 101, 102, 103, 104, 105, 106]"
metabase,20545,7112,5051,2061,"[164, 165, 166, 170, 426, 550, 560, 561, 563, 565, 569, 570, 573, 574, 575, 576, 577, 578, 579, 580, 581, 582, 583, 584, 585, 586, 587, 588, 589, 590, 591, 592, 593, 594, 595, 596, 597, 598, 599, 600, 601, 602, 603, 604, 605, 606, 607, 608, 609, 610, 611, 612, 613, 614, 615, 616, 617, 618, 619, 620, 622, 623, 624, 625, 626, 627, 628, 629, 630, 631, 632, 633, 634, 635, 636, 637, 638, 639, 640, 641, 642, 643, 644, 645, 646, 647, 648, 649, 650, 651, 652, 653, 654, 655, 656, 657, 658, 659, 660, 661]"
gym,20543,1105,1010,95,"[1, 3, 4, 5, 6, 7, 9, 11, 12, 14, 16, 17, 21, 27, 28, 33, 34, 35, 40, 41, 43, 45, 56, 59, 62, 67, 69, 70, 71, 72, 73, 74, 75, 76, 81, 83, 85, 87, 88, 91, 94, 95, 96, 99, 100, 103, 106, 108, 109, 110, 111, 114, 115, 116, 121, 122, 127, 128, 130, 131, 132, 133, 134, 136, 137, 142, 143, 145, 149, 151, 152, 154, 159, 162, 164, 165, 166, 167, 168, 184, 185, 188, 191, 195, 197, 204, 212, 213, 214, 216, 218, 219, 221, 222, 223, 224, 232, 234, 238, 239]"
imgui,20511,2539,2124,415,"[1, 2, 4, 5, 6, 7, 8, 12, 16, 17, 19, 21, 22, 23, 25, 26, 28, 30, 32, 36, 37, 38, 39, 42, 45, 46, 48, 50, 52, 53, 54, 55, 60, 61, 62, 63, 64, 65, 67, 68, 69, 70, 71, 72, 73, 74, 75, 76, 78, 81, 82, 84, 85, 87, 88, 89, 90, 91, 95, 96, 97, 98, 99, 100, 101, 102, 103, 104, 105, 106, 107, 108, 109, 110, 111, 112, 114, 115, 118, 119, 122, 123, 124, 125, 126, 127, 128, 129, 130, 131, 132, 133, 134, 136, 137, 138, 139, 140, 141, 143]"
nodemon,20490,1287,1275,12,"[2, 3, 6, 7, 8, 9, 10, 11, 12, 13, 14, 19, 20, 21, 23, 24, 25, 26, 27, 28, 30, 31, 32, 33, 34, 36, 37, 41, 42, 43, 44, 45, 47, 48, 49, 50, 51, 52, 53, 54, 56, 57, 58, 59, 60, 61, 62, 63, 64, 66, 68, 69, 71, 72, 73, 74, 75, 76, 77, 78, 79, 80, 82, 83, 86, 87, 88, 89, 92, 93, 95, 97, 98, 99, 104, 105, 107, 109, 110, 111, 112, 116, 117, 118, 120, 121, 122, 123, 125, 126, 127, 130, 131, 132, 134, 135, 136, 139, 140, 141]"
ngx-admin,20398,1540,1257,283,"[1, 2, 3, 5, 6, 7, 8, 9, 10, 11, 13, 14, 15, 16, 17, 19, 20, 22, 23, 25, 27, 28, 29, 30, 31, 33, 34, 36, 37, 38, 39, 41, 42, 43, 44, 45, 46, 50, 52, 53, 63, 64, 65, 69, 71, 76, 77, 78, 79, 83, 84, 85, 87, 88, 90, 93, 96, 97, 99, 102, 103, 108, 111, 113, 117, 118, 119, 120, 121, 122, 123, 125, 130, 132, 134, 135, 136, 137, 138, 139, 140, 141, 142, 143, 145, 146, 147, 148, 149, 150, 151, 153, 155, 156, 157, 158, 159, 162, 167, 169]"
metasploit-framework,20380,3818,3144,674,"[1, 53, 61, 114, 144, 146, 184, 235, 245, 357, 362, 377, 483, 499, 534, 540, 551, 565, 599, 600, 621, 622, 623, 681, 683, 727, 780, 796, 803, 809, 815, 832, 833, 854, 857, 896, 927, 1010, 1083, 1219, 1327, 1370, 1394, 1413, 1436, 1502, 1504, 1510, 1634, 1639, 1665, 1690, 1735, 1764, 1779, 1803, 1811, 1825, 1930, 1969, 2116, 2125, 2131, 2182, 2209, 2296, 2309, 2317, 2355, 2434, 2533, 2552, 2687, 2789, 2870, 2976, 2986, 3012, 3048, 3051, 3093, 3096, 3104, 3218, 3249, 3260, 3261, 3267, 3351, 3356, 3360, 3396, 3462, 3474, 3477, 3515, 3544, 3549, 3560, 3572]"
html2canvas,20363,1882,1307,575,"[1, 2, 3, 4, 5, 6, 7, 8, 9, 10, 12, 13, 14, 15, 18, 20, 21, 22, 23, 24, 26, 27, 28, 36, 39, 42, 43, 44, 45, 46, 47, 51, 52, 56, 57, 58, 59, 60, 61, 64, 65, 66, 68, 69, 79, 80, 81, 83, 84, 85, 86, 87, 89, 90, 93, 94, 95, 96, 97, 98, 101, 103, 104, 105, 106, 107, 108, 109, 110, 111, 112, 113, 114, 115, 116, 117, 118, 119, 120, 121, 122, 123, 124, 125, 126, 128, 131, 132, 133, 134, 135, 137, 138, 139, 140, 141, 142, 143, 144, 145]"
redux-saga,20322,1309,1157,152,"[2, 5, 6, 7, 8, 9, 10, 13, 14, 15, 16, 21, 22, 23, 27, 28, 29, 30, 32, 34, 35, 37, 38, 39, 40, 43, 46, 47, 48, 49, 50, 51, 53, 54, 55, 58, 59, 60, 61, 62, 63, 64, 67, 68, 69, 70, 73, 74, 76, 78, 79, 81, 82, 83, 84, 85, 86, 93, 103, 105, 107, 108, 110, 114, 118, 123, 124, 133, 134, 141, 144, 146, 148, 149, 152, 153, 154, 155, 156, 157, 159, 160, 161, 162, 163, 164, 166, 167, 168, 171, 172, 173, 174, 175, 176, 177, 178, 179, 180, 181]"
ItChat,20281,800,592,208,"[1, 3, 4, 5, 6, 7, 8, 9, 10, 11, 12, 15, 16, 17, 18, 19, 20, 21, 22, 23, 24, 27, 28, 29, 30, 31, 32, 33, 34, 37, 38, 41, 43, 44, 48, 49, 50, 51, 52, 53, 55, 56, 57, 58, 59, 60, 61, 62, 63, 64, 65, 66, 67, 68, 69, 70, 71, 73, 74, 75, 76, 77, 78, 79, 82, 83, 84, 85, 86, 87, 88, 89, 90, 94, 96, 97, 98, 100, 101, 102, 104, 105, 106, 107, 108, 109, 110, 113, 114, 115, 117, 120, 125, 128, 130, 131, 132, 135, 136, 137]"
uBlock,20276,3449,3377,72,"[1, 2, 6, 7, 8, 9, 10, 12, 14, 15, 16, 38, 39, 40, 41, 42, 43, 44, 45, 46, 47, 48, 49, 50, 51, 52, 53, 54, 55, 57, 58, 59, 60, 61, 62, 63, 64, 65, 66, 67, 69, 70, 71, 72, 73, 74, 75, 76, 77, 78, 80, 83, 84, 85, 86, 87, 88, 89, 90, 91, 92, 93, 94, 95, 96, 97, 98, 99, 100, 101, 102, 103, 104, 105, 106, 108, 109, 110, 111, 112, 113, 114, 115, 116, 117, 118, 119, 120, 121, 122, 123, 124, 125, 127, 128, 129, 130, 131, 132, 133]"
pipenv,20218,3016,2628,388,"[1, 2, 3, 6, 8, 9, 10, 11, 12, 13, 14, 15, 16, 17, 19, 20, 21, 22, 23, 24, 25, 26, 27, 29, 30, 31, 32, 33, 34, 38, 40, 42, 43, 44, 47, 48, 49, 50, 51, 52, 53, 54, 55, 56, 57, 58, 59, 61, 63, 64, 65, 66, 67, 68, 69, 70, 71, 73, 74, 76, 78, 79, 81, 83, 84, 86, 88, 89, 90, 91, 92, 93, 94, 95, 98, 103, 104, 107, 108, 109, 112, 114, 116, 117, 120, 124, 125, 126, 128, 129, 130, 132, 137, 140, 142, 143, 144, 146, 147, 148]"
PowerToys,20204,1941,1047,894,"[4, 5, 6, 7, 8, 10, 11, 12, 13, 14, 16, 18, 19, 20, 21, 22, 23, 24, 26, 27, 28, 30, 31, 32, 33, 34, 35, 37, 38, 39, 41, 42, 43, 44, 46, 47, 48, 49, 50, 51, 52, 53, 54, 55, 57, 58, 59, 60, 61, 62, 63, 64, 65, 66, 67, 68, 69, 70, 71, 72, 73, 74, 75, 76, 77, 78, 79, 80, 81, 82, 83, 84, 85, 86, 87, 88, 89, 90, 91, 92, 93, 94, 95, 96, 97, 98, 99, 100, 101, 102, 103, 104, 105, 106, 107, 109, 110, 111, 112, 113]"
awesome-javascript,20184,71,54,17,"[2, 26, 30, 56, 62, 73, 76, 83, 86, 89, 90, 98, 100, 101, 102, 113, 138, 139, 143, 153, 158, 180, 181, 183, 198, 200, 226, 227, 230, 231, 236, 261, 280, 299, 346, 347, 348, 349, 350, 351, 373, 379, 387, 399, 410, 417, 438, 453, 485, 488, 501, 503, 504, 510, 513, 517, 519, 529, 544, 567, 570, 573, 575, 577, 585, 601, 608, 611, 636, 659, 682]"
wepy,20169,2017,1712,305,"[2, 3, 4, 5, 8, 9, 10, 11, 12, 13, 14, 15, 16, 17, 18, 19, 20, 21, 22, 23, 24, 25, 26, 27, 28, 29, 30, 31, 32, 33, 34, 35, 36, 38, 39, 41, 43, 44, 45, 50, 51, 52, 53, 54, 55, 56, 57, 58, 59, 60, 61, 62, 63, 64, 65, 66, 67, 68, 69, 70, 71, 74, 75, 79, 81, 83, 84, 87, 88, 89, 90, 91, 92, 94, 95, 96, 97, 99, 100, 101, 105, 106, 107, 108, 110, 111, 112, 114, 115, 117, 118, 119, 121, 122, 123, 125, 126, 127, 128, 130]"
CodeMirror,20157,3661,3318,343,"[1, 3, 4, 5, 6, 7, 8, 9, 10, 11, 12, 13, 16, 17, 18, 19, 20, 22, 23, 24, 25, 26, 27, 28, 29, 30, 31, 33, 34, 35, 36, 37, 38, 40, 42, 43, 45, 46, 47, 48, 49, 50, 51, 53, 54, 56, 57, 58, 59, 60, 61, 62, 63, 64, 66, 67, 68, 69, 71, 73, 74, 76, 77, 78, 80, 81, 83, 86, 87, 89, 90, 92, 93, 95, 97, 100, 102, 103, 104, 105, 106, 107, 108, 110, 111, 114, 116, 117, 120, 121, 122, 123, 124, 125, 127, 129, 131, 134, 135, 136]"
bootstrap-material-design,20146,1082,1027,55,"[1, 2, 3, 4, 5, 6, 7, 8, 9, 10, 12, 13, 14, 15, 17, 18, 19, 20, 22, 24, 26, 27, 30, 32, 33, 34, 35, 38, 39, 40, 41, 42, 44, 46, 47, 48, 50, 52, 53, 54, 55, 56, 57, 58, 60, 62, 63, 64, 65, 67, 70, 73, 74, 75, 76, 80, 81, 83, 84, 88, 90, 93, 94, 97, 98, 99, 102, 103, 105, 106, 107, 110, 111, 116, 117, 119, 120, 121, 122, 123, 125, 126, 127, 130, 131, 132, 133, 134, 135, 136, 137, 138, 139, 140, 141, 142, 144, 145, 147, 148]"
react-starter-kit,20074,1146,708,438,"[1, 2, 3, 4, 5, 6, 7, 8, 10, 11, 12, 13, 14, 15, 16, 17, 18, 20, 22, 23, 25, 27, 28, 29, 30, 32, 33, 34, 37, 39, 40, 41, 42, 43, 46, 51, 52, 53, 54, 55, 56, 57, 59, 61, 67, 68, 70, 71, 72, 73, 76, 77, 79, 81, 83, 84, 85, 86, 87, 88, 91, 92, 93, 97, 98, 99, 100, 101, 102, 104, 105, 107, 108, 110, 111, 114, 116, 117, 118, 119, 121, 124, 125, 126, 127, 129, 130, 131, 132, 133, 134, 135, 138, 139, 144, 145, 146, 147, 149, 150]"
the_silver_searcher,20069,739,388,351,"[24, 28, 29, 30, 32, 33, 34, 35, 36, 40, 41, 42, 43, 46, 49, 50, 51, 57, 61, 62, 63, 67, 69, 70, 71, 73, 74, 75, 79, 81, 83, 84, 86, 90, 96, 98, 100, 101, 102, 103, 107, 108, 109, 111, 112, 114, 120, 122, 124, 127, 128, 134, 136, 137, 143, 144, 146, 147, 150, 152, 153, 155, 156, 157, 159, 160, 161, 168, 173, 174, 179, 182, 183, 184, 185, 186, 187, 188, 189, 191, 192, 193, 194, 196, 200, 201, 206, 207, 208, 209, 210, 212, 213, 214, 215, 217, 218, 220, 223, 225]"
vim,20032,3612,2682,930,"[1, 2, 3, 4, 5, 6, 7, 8, 9, 10, 11, 12, 13, 14, 15, 16, 17, 18, 19, 20, 21, 22, 23, 24, 25, 26, 27, 28, 29, 30, 31, 32, 33, 34, 35, 36, 37, 38, 39, 40, 41, 42, 43, 44, 45, 46, 47, 48, 49, 50, 51, 52, 53, 54, 55, 56, 57, 58, 59, 60, 61, 62, 63, 64, 65, 66, 67, 68, 69, 70, 71, 72, 73, 74, 75, 76, 77, 78, 79, 80, 81, 82, 83, 84, 85, 86, 87, 88, 89, 90, 91, 92, 93, 94, 95, 96, 97, 98, 99, 100]"
Sortable,20007,1392,1167,225,"[1, 2, 3, 4, 5, 6, 7, 8, 9, 11, 15, 16, 18, 19, 20, 21, 22, 23, 24, 25, 26, 27, 28, 30, 33, 34, 35, 36, 38, 39, 40, 41, 44, 45, 46, 48, 50, 52, 53, 54, 57, 58, 59, 61, 66, 67, 68, 69, 71, 73, 75, 76, 77, 78, 79, 80, 81, 82, 83, 84, 85, 86, 87, 88, 89, 90, 91, 92, 93, 95, 96, 97, 98, 99, 100, 102, 103, 104, 105, 106, 107, 108, 109, 110, 113, 114, 119, 120, 121, 122, 123, 125, 128, 129, 130, 131, 132, 133, 134, 136]"
PhotoSwipe,19953,1515,1016,499,"[1, 2, 3, 4, 5, 6, 7, 8, 9, 10, 11, 12, 13, 14, 15, 16, 17, 18, 19, 20, 22, 23, 24, 25, 26, 27, 28, 29, 30, 31, 32, 33, 34, 35, 36, 37, 38, 39, 40, 41, 42, 43, 44, 45, 46, 47, 48, 50, 51, 53, 54, 55, 56, 57, 58, 59, 60, 61, 62, 63, 64, 65, 66, 67, 68, 69, 70, 71, 72, 73, 74, 75, 76, 77, 78, 79, 80, 81, 82, 83, 85, 86, 87, 88, 89, 90, 91, 92, 93, 94, 95, 96, 97, 98, 99, 100, 101, 102, 103, 104]"
funNLP,19934,25,22,3,"[1, 2, 5, 9, 10, 11, 13, 14, 15, 16, 17, 23, 24, 26, 27, 28, 30, 31, 32, 33, 34, 35, 36, 37, 38]"
react-select,19929,2670,1471,1199,"[1, 2, 3, 4, 5, 7, 9, 11, 13, 14, 15, 16, 19, 21, 22, 23, 24, 25, 26, 28, 35, 38, 40, 41, 44, 45, 46, 47, 48, 49, 51, 55, 57, 58, 59, 60, 61, 63, 64, 68, 69, 70, 73, 74, 75, 76, 77, 83, 84, 86, 87, 88, 89, 90, 91, 92, 94, 96, 97, 99, 102, 104, 105, 108, 109, 111, 112, 113, 114, 115, 117, 120, 121, 122, 123, 126, 127, 128, 129, 130, 133, 134, 135, 138, 139, 142, 144, 145, 146, 148, 149, 150, 153, 155, 158, 161, 164, 165, 166, 167]"
spacemacs,19922,7328,4998,2330,"[2, 3, 4, 5, 6, 7, 8, 9, 10, 11, 12, 14, 15, 16, 17, 18, 21, 22, 23, 25, 26, 28, 29, 30, 31, 32, 33, 34, 35, 36, 40, 41, 42, 43, 44, 45, 46, 47, 48, 50, 51, 52, 53, 55, 56, 60, 62, 64, 65, 70, 72, 77, 78, 79, 81, 86, 90, 98, 101, 102, 103, 104, 105, 107, 109, 110, 112, 115, 121, 123, 127, 128, 129, 130, 131, 132, 133, 136, 143, 144, 145, 146, 147, 148, 149, 152, 158, 161, 162, 163, 165, 166, 169, 170, 175, 177, 178, 181, 182, 183]"
octotree,19902,570,513,57,"[5, 6, 7, 8, 9, 10, 11, 13, 15, 16, 18, 19, 20, 21, 22, 25, 28, 29, 30, 31, 32, 33, 34, 35, 36, 37, 40, 41, 45, 46, 49, 50, 51, 54, 55, 56, 63, 64, 73, 74, 75, 76, 77, 79, 80, 81, 82, 83, 84, 85, 87, 89, 90, 91, 93, 94, 95, 97, 101, 102, 103, 104, 105, 109, 110, 111, 112, 117, 118, 119, 120, 121, 122, 123, 125, 128, 129, 130, 132, 133, 134, 135, 136, 137, 139, 140, 141, 142, 143, 144, 145, 146, 147, 150, 151, 152, 155, 157, 158, 159]"
cypress,19898,5345,4162,1183,"[1, 2, 3, 4, 5, 7, 8, 9, 10, 11, 12, 13, 14, 15, 16, 17, 18, 19, 20, 21, 22, 23, 24, 25, 26, 27, 28, 29, 30, 31, 32, 33, 34, 35, 36, 37, 38, 39, 40, 41, 42, 43, 44, 45, 46, 47, 48, 49, 50, 51, 52, 53, 54, 55, 56, 57, 58, 59, 60, 61, 62, 63, 64, 65, 66, 67, 68, 69, 70, 71, 72, 73, 74, 75, 76, 77, 78, 79, 80, 81, 82, 83, 84, 85, 86, 87, 88, 89, 90, 91, 92, 93, 94, 95, 96, 97, 98, 99, 100, 101]"
monaco-editor,19897,1781,1426,355,"[1, 2, 3, 5, 6, 9, 10, 11, 13, 16, 17, 18, 19, 20, 21, 22, 23, 24, 25, 26, 27, 28, 29, 30, 31, 32, 33, 34, 35, 36, 37, 38, 39, 40, 41, 42, 43, 44, 45, 46, 47, 48, 49, 50, 51, 52, 53, 54, 55, 56, 57, 58, 59, 60, 61, 62, 63, 64, 65, 66, 67, 68, 69, 70, 71, 72, 73, 74, 75, 77, 78, 79, 80, 81, 82, 83, 84, 86, 87, 88, 89, 90, 91, 92, 93, 94, 95, 96, 97, 98, 99, 100, 101, 102, 103, 104, 105, 107, 108, 109]"
dive,19889,187,134,53,"[4, 11, 12, 13, 14, 19, 20, 21, 25, 26, 27, 28, 29, 30, 31, 32, 33, 35, 38, 42, 44, 45, 46, 47, 49, 50, 51, 52, 55, 56, 58, 59, 60, 61, 62, 63, 64, 65, 66, 67, 69, 70, 71, 72, 74, 75, 76, 79, 80, 81, 82, 83, 84, 85, 86, 88, 89, 90, 93, 94, 95, 96, 97, 98, 99, 105, 106, 107, 109, 110, 111, 112, 113, 116, 117, 118, 119, 123, 124, 125, 126, 128, 129, 130, 132, 134, 135, 136, 137, 139, 140, 144, 145, 146, 147, 151, 153, 154, 157, 158]"
modern-js-cheatsheet,19859,42,36,6,"[1, 4, 13, 15, 16, 18, 19, 20, 22, 25, 27, 28, 32, 33, 36, 37, 38, 39, 42, 44, 45, 48, 49, 50, 51, 52, 54, 55, 57, 61, 62, 65, 68, 76, 79, 82, 86, 90, 97, 100, 103, 111]"
BaseRecyclerViewAdapterHelper,19857,2903,2768,135,"[2, 9, 13, 15, 16, 17, 18, 19, 20, 21, 22, 23, 24, 25, 26, 27, 28, 29, 30, 31, 32, 33, 34, 35, 36, 38, 39, 40, 41, 43, 44, 45, 46, 47, 48, 49, 50, 51, 52, 56, 57, 58, 60, 61, 62, 63, 64, 65, 68, 69, 70, 71, 72, 73, 74, 75, 76, 77, 79, 80, 82, 86, 87, 88, 90, 93, 94, 96, 97, 98, 102, 103, 104, 105, 106, 107, 108, 109, 110, 111, 112, 113, 114, 115, 116, 117, 118, 119, 120, 121, 122, 123, 124, 126, 128, 129, 130, 131, 132, 133]"
aria2,19851,1336,647,689,"[3, 7, 10, 11, 15, 17, 19, 21, 26, 27, 29, 30, 32, 33, 35, 37, 39, 40, 41, 42, 44, 45, 56, 62, 64, 66, 68, 71, 72, 75, 76, 77, 78, 79, 80, 81, 84, 85, 86, 87, 91, 94, 95, 96, 99, 100, 101, 102, 107, 108, 109, 110, 111, 112, 113, 116, 118, 120, 121, 123, 124, 125, 126, 127, 129, 132, 136, 137, 139, 140, 142, 143, 144, 145, 146, 147, 148, 149, 153, 154, 155, 156, 157, 162, 163, 164, 165, 166, 167, 168, 169, 170, 171, 172, 173, 174, 175, 176, 177, 178]"
pop,19836,255,211,44,"[1, 2, 7, 8, 9, 10, 12, 13, 14, 15, 17, 18, 19, 21, 24, 25, 28, 29, 32, 34, 36, 37, 39, 42, 43, 46, 47, 48, 50, 51, 52, 55, 56, 58, 61, 62, 64, 65, 68, 71, 72, 73, 74, 76, 77, 78, 79, 80, 82, 86, 87, 90, 91, 92, 93, 95, 97, 99, 101, 104, 106, 107, 108, 109, 111, 112, 113, 114, 116, 117, 118, 119, 120, 121, 122, 123, 124, 129, 131, 133, 134, 135, 136, 137, 138, 143, 144, 146, 151, 153, 154, 155, 156, 157, 158, 159, 160, 161, 162, 163]"
vagrant,19796,8389,7981,408,"[1, 2, 3, 4, 5, 6, 7, 8, 9, 10, 11, 12, 13, 14, 15, 16, 17, 18, 19, 20, 21, 22, 23, 24, 25, 26, 27, 28, 29, 30, 31, 32, 33, 34, 35, 36, 37, 38, 39, 40, 41, 42, 43, 44, 45, 46, 47, 48, 49, 50, 51, 52, 53, 54, 55, 56, 57, 58, 59, 61, 62, 63, 64, 65, 66, 67, 68, 69, 70, 71, 72, 73, 74, 75, 76, 77, 78, 79, 80, 81, 82, 83, 84, 85, 86, 87, 88, 89, 90, 91, 92, 93, 94, 95, 96, 97, 98, 99, 100, 101]"
ReactiveCocoa,19772,1988,1945,43,"[1, 2, 10, 11, 12, 13, 14, 15, 17, 19, 20, 21, 26, 27, 40, 42, 43, 48, 63, 70, 72, 73, 82, 87, 89, 90, 93, 94, 99, 100, 105, 106, 107, 108, 109, 111, 113, 122, 123, 125, 126, 127, 129, 132, 133, 136, 138, 140, 141, 143, 146, 152, 155, 156, 157, 158, 159, 160, 161, 162, 166, 171, 173, 176, 177, 179, 186, 187, 188, 190, 191, 192, 194, 195, 201, 202, 204, 205, 212, 215, 220, 221, 224, 226, 228, 231, 234, 238, 239, 242, 243, 244, 247, 249, 254, 256, 257, 258, 267, 272]"
dragula,19746,467,289,178,"[1, 3, 5, 6, 7, 8, 10, 12, 13, 14, 15, 16, 18, 19, 20, 23, 24, 25, 26, 27, 28, 29, 30, 31, 33, 34, 35, 36, 37, 39, 40, 42, 43, 44, 45, 46, 47, 48, 49, 50, 51, 52, 53, 54, 55, 56, 57, 59, 60, 61, 63, 65, 66, 68, 69, 70, 71, 72, 74, 75, 76, 77, 80, 85, 86, 87, 88, 89, 90, 91, 92, 93, 95, 96, 97, 98, 99, 101, 102, 103, 105, 106, 108, 110, 111, 112, 113, 114, 115, 117, 118, 119, 120, 121, 124, 125, 128, 130, 135, 136]"
shellcheck,19746,1660,1119,541,"[1, 2, 3, 4, 5, 6, 8, 9, 10, 11, 13, 14, 15, 17, 18, 19, 20, 21, 22, 23, 24, 25, 26, 27, 28, 29, 30, 31, 32, 34, 35, 36, 37, 38, 39, 40, 41, 42, 43, 44, 45, 46, 47, 48, 49, 50, 51, 52, 53, 54, 56, 57, 58, 59, 60, 62, 63, 64, 65, 66, 68, 69, 70, 71, 72, 73, 74, 76, 77, 78, 79, 80, 81, 82, 84, 85, 86, 87, 88, 89, 90, 91, 92, 93, 94, 95, 96, 97, 98, 99, 100, 101, 102, 103, 104, 106, 107, 108, 109, 110]"
iosched,19745,199,170,29,"[6, 9, 10, 11, 12, 19, 20, 25, 29, 30, 36, 37, 38, 40, 41, 48, 49, 51, 52, 54, 55, 57, 58, 59, 61, 66, 67, 72, 73, 75, 76, 77, 79, 80, 81, 82, 83, 84, 85, 86, 88, 89, 91, 92, 94, 97, 99, 100, 101, 102, 103, 104, 105, 106, 108, 111, 112, 114, 115, 116, 117, 118, 123, 126, 127, 128, 129, 130, 131, 132, 133, 134, 135, 137, 138, 139, 141, 143, 144, 145, 146, 147, 149, 151, 152, 153, 154, 155, 167, 168, 169, 171, 172, 174, 175, 178, 179, 180, 181, 182]"
components,19744,10845,8728,2117,"[1, 11, 13, 19, 30, 31, 32, 33, 34, 35, 36, 37, 39, 40, 41, 42, 43, 45, 46, 48, 49, 50, 51, 54, 55, 56, 62, 70, 72, 73, 74, 75, 76, 79, 81, 83, 84, 85, 88, 90, 91, 92, 93, 98, 99, 100, 101, 102, 103, 104, 105, 106, 107, 108, 109, 110, 111, 112, 113, 114, 115, 116, 117, 118, 119, 120, 121, 122, 123, 128, 133, 140, 141, 142, 147, 150, 162, 164, 165, 167, 168, 170, 171, 172, 174, 175, 177, 178, 183, 188, 189, 191, 192, 198, 199, 200, 203, 205, 207, 208]"
RxJS,19736,874,643,231,"[2, 3, 4, 5, 6, 7, 8, 9, 10, 13, 14, 15, 16, 17, 18, 19, 21, 22, 23, 24, 25, 28, 29, 31, 32, 34, 35, 38, 39, 40, 41, 42, 43, 44, 45, 46, 47, 53, 54, 55, 56, 57, 58, 59, 65, 66, 68, 69, 73, 74, 77, 79, 80, 81, 82, 83, 84, 85, 86, 87, 88, 89, 90, 91, 92, 93, 94, 97, 99, 101, 104, 108, 109, 111, 112, 113, 114, 115, 116, 119, 121, 122, 123, 124, 125, 127, 131, 134, 135, 136, 137, 141, 142, 143, 146, 148, 149, 150, 151, 152]"
interactive-coding-challenges,19726,52,29,23,"[1, 2, 3, 4, 7, 8, 10, 11, 12, 13, 14, 17, 21, 22, 23, 24, 27, 31, 32, 33, 35, 38, 47, 170, 173, 174, 185, 193, 195, 197, 201, 203, 205, 209, 219, 220, 224, 225, 230, 235, 236, 238, 240, 244, 248, 253, 256, 258, 264, 267, 268, 269]"
calculator,19725,571,414,157,"[24, 28, 42, 43, 44, 45, 46, 47, 48, 49, 50, 51, 52, 53, 54, 55, 56, 57, 58, 59, 60, 61, 62, 63, 64, 65, 66, 67, 68, 69, 70, 71, 72, 73, 74, 75, 76, 77, 78, 79, 80, 83, 87, 89, 90, 98, 102, 103, 105, 107, 108, 109, 111, 112, 113, 114, 115, 116, 117, 119, 120, 122, 123, 127, 128, 130, 133, 138, 139, 140, 141, 142, 143, 147, 148, 150, 152, 153, 154, 155, 157, 161, 162, 163, 164, 167, 168, 169, 170, 172, 173, 174, 175, 177, 178, 179, 180, 181, 191, 202]"
awesome-sysadmin,19718,92,21,71,"[46, 54, 60, 72, 100, 118, 126, 149, 169, 174, 175, 176, 177, 178, 179, 180, 181, 182, 183, 184, 193, 196, 197, 209, 223, 224, 225, 226, 227, 233, 236, 237, 243, 249, 261, 262, 267, 288, 289, 307, 308, 320, 321, 324, 329, 330, 335, 336, 338, 344, 345, 347, 348, 353, 354, 356, 358, 368, 379, 385, 386, 392, 394, 396, 400, 401, 429, 445, 446, 449, 450, 451, 452, 453, 455, 458, 462, 471, 479, 486, 487, 500, 501, 506, 517, 522, 527, 528, 529, 536, 547, 548]"
mpvue,19708,1658,1256,402,"[1, 2, 4, 5, 6, 7, 8, 9, 10, 11, 12, 13, 14, 15, 16, 17, 18, 19, 20, 21, 22, 23, 26, 27, 29, 30, 31, 32, 33, 34, 35, 36, 37, 38, 39, 40, 41, 42, 43, 45, 46, 47, 48, 49, 50, 51, 52, 53, 54, 55, 56, 57, 58, 59, 60, 61, 62, 63, 64, 65, 66, 67, 68, 69, 70, 71, 72, 73, 74, 75, 77, 78, 79, 80, 81, 83, 84, 85, 86, 87, 89, 91, 92, 93, 94, 95, 96, 97, 98, 99, 100, 101, 102, 103, 105, 106, 107, 108, 109, 110]"
lighthouse,19704,6752,6342,410,"[4, 17, 19, 20, 21, 22, 23, 24, 25, 26, 27, 28, 33, 35, 36, 37, 38, 41, 45, 46, 52, 53, 56, 57, 59, 61, 65, 69, 70, 73, 77, 80, 81, 82, 83, 89, 92, 98, 99, 100, 101, 105, 106, 107, 110, 118, 126, 127, 133, 135, 138, 142, 143, 144, 146, 149, 151, 152, 157, 158, 159, 160, 163, 168, 170, 171, 172, 177, 179, 183, 184, 188, 194, 197, 200, 207, 210, 211, 213, 217, 218, 219, 220, 222, 224, 227, 229, 233, 236, 240, 248, 260, 261, 263, 266, 269, 272, 274, 275, 277]"
handson-ml,19676,482,387,95,"[1, 2, 4, 5, 6, 7, 8, 9, 10, 11, 12, 13, 14, 15, 16, 17, 18, 20, 21, 22, 23, 24, 25, 26, 28, 29, 30, 31, 32, 33, 34, 35, 37, 38, 39, 40, 41, 42, 43, 44, 45, 46, 47, 49, 50, 51, 54, 55, 56, 57, 58, 59, 60, 61, 63, 64, 65, 67, 68, 69, 70, 71, 72, 73, 74, 75, 78, 79, 80, 81, 82, 83, 85, 86, 87, 88, 89, 90, 91, 93, 94, 95, 96, 97, 101, 102, 103, 104, 106, 108, 109, 110, 111, 112, 114, 115, 116, 117, 118, 119]"
upterm,19643,753,534,219,"[1, 2, 7, 8, 9, 10, 11, 12, 13, 14, 15, 16, 17, 18, 19, 20, 21, 23, 24, 26, 27, 28, 30, 31, 32, 33, 34, 35, 36, 39, 40, 41, 42, 43, 44, 45, 46, 47, 48, 49, 50, 51, 55, 57, 58, 59, 60, 61, 62, 63, 64, 65, 66, 68, 71, 72, 73, 74, 77, 78, 79, 81, 82, 83, 86, 90, 94, 95, 99, 101, 102, 103, 104, 105, 107, 108, 110, 111, 112, 114, 115, 116, 119, 120, 121, 124, 125, 126, 127, 131, 132, 133, 134, 135, 137, 138, 139, 140, 141, 142]"
Awesome-Design-Tools,19634,24,21,3,"[2, 26, 29, 31, 58, 62, 66, 71, 84, 85, 92, 113, 118, 121, 129, 131, 154, 199, 204, 208, 227, 264, 310, 314]"
gitea,19596,5355,4080,1275,"[6, 7, 8, 9, 10, 11, 12, 13, 14, 15, 24, 25, 26, 27, 28, 29, 30, 31, 32, 35, 36, 38, 42, 52, 55, 56, 57, 63, 64, 66, 70, 76, 77, 80, 87, 89, 91, 92, 93, 99, 102, 104, 105, 114, 118, 123, 124, 126, 132, 137, 143, 145, 151, 158, 162, 165, 177, 178, 179, 180, 182, 183, 184, 185, 188, 189, 194, 195, 200, 207, 209, 210, 211, 217, 218, 219, 220, 221, 236, 257, 258, 261, 277, 278, 279, 280, 282, 283, 286, 296, 301, 302, 304, 305, 307, 308, 309, 310, 311, 312]"
awesome-electron,19592,44,35,9,"[5, 7, 23, 33, 44, 88, 94, 95, 124, 139, 155, 180, 199, 215, 229, 238, 245, 248, 250, 251, 307, 330, 375, 378, 410, 432, 445, 456, 466, 479, 482, 494, 498, 505, 510, 519, 538, 546, 548, 573, 577, 609, 612, 613]"
hub,19568,1689,1491,198,"[1, 2, 3, 4, 5, 6, 7, 8, 9, 10, 11, 12, 13, 14, 15, 16, 17, 18, 19, 20, 21, 22, 23, 24, 25, 26, 27, 28, 29, 30, 31, 32, 33, 34, 35, 36, 37, 38, 39, 40, 41, 42, 43, 44, 45, 46, 47, 48, 49, 50, 51, 52, 54, 56, 59, 61, 62, 63, 64, 69, 70, 71, 72, 74, 75, 76, 78, 79, 82, 83, 84, 86, 88, 89, 91, 92, 93, 98, 99, 100, 103, 104, 107, 108, 109, 111, 112, 113, 114, 115, 116, 118, 120, 122, 123, 124, 125, 126, 129, 130]"
Hystrix,19567,996,671,325,"[8, 9, 10, 11, 12, 13, 14, 15, 20, 22, 24, 25, 26, 28, 34, 38, 39, 40, 41, 45, 46, 53, 54, 55, 58, 59, 60, 63, 68, 69, 70, 72, 74, 75, 78, 80, 82, 85, 87, 88, 89, 90, 92, 96, 98, 100, 101, 102, 109, 113, 115, 116, 117, 118, 122, 123, 124, 125, 127, 129, 131, 132, 134, 140, 143, 145, 147, 150, 153, 154, 157, 160, 161, 166, 167, 172, 174, 175, 176, 178, 180, 186, 187, 188, 191, 192, 195, 197, 198, 200, 201, 202, 205, 208, 212, 220, 223, 225, 226, 227]"
SwiftyJSON,19554,646,558,88,"[1, 2, 4, 5, 7, 8, 9, 10, 11, 12, 14, 17, 22, 24, 25, 32, 35, 37, 38, 39, 40, 42, 44, 46, 47, 48, 49, 52, 57, 60, 62, 64, 66, 67, 69, 70, 71, 75, 76, 77, 78, 79, 80, 81, 82, 86, 88, 89, 90, 93, 95, 96, 97, 101, 102, 105, 107, 108, 109, 110, 112, 116, 118, 120, 122, 125, 126, 129, 130, 131, 132, 133, 140, 141, 143, 144, 145, 147, 148, 150, 151, 157, 159, 160, 161, 162, 163, 164, 165, 166, 168, 171, 173, 175, 177, 179, 180, 181, 182, 183]"
bat,19542,552,527,25,"[1, 2, 3, 4, 5, 6, 7, 8, 9, 10, 11, 12, 13, 14, 15, 16, 17, 18, 19, 20, 21, 22, 23, 25, 26, 27, 28, 29, 30, 31, 33, 34, 35, 36, 37, 41, 44, 45, 46, 48, 50, 51, 52, 54, 55, 56, 57, 58, 59, 60, 64, 66, 68, 69, 70, 72, 76, 77, 80, 81, 83, 84, 85, 89, 91, 92, 94, 97, 98, 99, 100, 101, 103, 106, 107, 111, 112, 115, 117, 118, 119, 120, 124, 126, 127, 130, 131, 134, 138, 142, 144, 145, 147, 148, 150, 151, 155, 157, 158, 159]"
ripgrep,19537,1063,1011,52,"[1, 2, 3, 4, 5, 6, 7, 8, 9, 10, 12, 13, 14, 15, 16, 17, 18, 19, 20, 21, 22, 23, 24, 25, 26, 27, 30, 31, 32, 33, 34, 35, 36, 37, 38, 40, 43, 44, 45, 46, 47, 48, 49, 50, 51, 52, 53, 54, 55, 57, 59, 60, 61, 63, 64, 65, 67, 68, 70, 72, 73, 74, 75, 76, 77, 79, 80, 81, 82, 83, 85, 86, 87, 88, 89, 90, 91, 93, 94, 95, 96, 97, 98, 99, 101, 102, 103, 105, 106, 108, 109, 110, 112, 113, 116, 117, 118, 119, 123, 124]"
compose,19472,4874,4553,321,"[1, 2, 6, 7, 8, 9, 11, 12, 17, 26, 27, 28, 31, 32, 35, 37, 38, 41, 42, 43, 44, 45, 48, 49, 51, 53, 56, 57, 59, 61, 62, 63, 64, 69, 71, 72, 73, 75, 81, 84, 85, 88, 89, 90, 93, 94, 95, 96, 97, 98, 99, 101, 102, 103, 105, 106, 107, 108, 110, 112, 115, 116, 117, 118, 121, 122, 123, 126, 127, 129, 134, 136, 137, 138, 142, 144, 147, 149, 152, 153, 156, 157, 158, 159, 160, 161, 163, 167, 168, 169, 170, 172, 174, 175, 176, 177, 178, 179, 181, 184]"
lottie-ios,19467,805,676,129,"[4, 5, 6, 13, 14, 15, 16, 17, 21, 22, 23, 25, 26, 30, 31, 32, 35, 36, 37, 40, 41, 42, 43, 44, 45, 47, 48, 49, 52, 53, 54, 55, 56, 57, 58, 60, 61, 62, 65, 66, 67, 72, 73, 75, 78, 80, 82, 83, 84, 86, 88, 89, 92, 93, 94, 95, 97, 98, 100, 103, 104, 105, 107, 108, 109, 111, 112, 114, 115, 117, 118, 119, 120, 122, 125, 129, 131, 132, 133, 134, 135, 136, 139, 140, 141, 142, 145, 146, 149, 150, 151, 152, 157, 159, 160, 161, 162, 165, 166, 167]"
react-redux,19408,1037,1015,22,"[1, 2, 3, 5, 6, 7, 8, 9, 10, 12, 20, 21, 22, 23, 24, 27, 28, 30, 32, 33, 37, 39, 41, 43, 45, 47, 48, 49, 52, 53, 56, 57, 58, 60, 61, 63, 64, 65, 66, 68, 74, 75, 76, 79, 82, 83, 86, 87, 88, 89, 91, 92, 94, 95, 97, 98, 100, 101, 102, 103, 108, 110, 111, 112, 113, 114, 115, 116, 118, 119, 120, 121, 123, 124, 125, 126, 128, 129, 130, 131, 132, 133, 136, 137, 139, 140, 141, 144, 145, 148, 150, 154, 155, 156, 157, 159, 160, 161, 162, 163]"
FFmpeg,19394,0,0,0,[]
the-swift-programming-language-in-chinese,19344,320,320,0,"[2, 3, 4, 5, 6, 8, 23, 25, 28, 34, 39, 40, 47, 48, 51, 54, 55, 58, 62, 65, 69, 71, 74, 76, 77, 94, 99, 100, 102, 106, 107, 109, 111, 112, 113, 119, 120, 121, 124, 127, 129, 132, 133, 136, 140, 141, 142, 146, 147, 148, 154, 170, 172, 175, 177, 180, 199, 208, 216, 217, 218, 224, 227, 255, 258, 259, 267, 272, 279, 280, 281, 287, 299, 302, 304, 306, 308, 309, 326, 327, 331, 334, 335, 343, 346, 347, 348, 349, 351, 352, 356, 357, 367, 372, 378, 379, 383, 417, 435, 436]"
English-level-up-tips-for-Chinese,19331,54,43,11,"[1, 2, 3, 6, 7, 8, 9, 12, 13, 15, 16, 17, 18, 20, 21, 22, 24, 25, 27, 29, 33, 34, 36, 40, 42, 43, 44, 45, 46, 50, 51, 52, 55, 56, 57, 58, 59, 60, 61, 62, 65, 66, 67, 68, 69, 70, 71, 72, 73, 74, 75, 76, 77, 78]"
awesome-shell,19293,37,16,21,"[4, 12, 21, 42, 49, 60, 78, 87, 97, 110, 120, 136, 146, 178, 211, 230, 250, 262, 269, 272, 297, 298, 301, 311, 314, 316, 321, 325, 328, 329, 331, 332, 341, 361, 377, 382, 387]"
mocha,19269,2497,2246,251,"[1, 2, 3, 4, 5, 6, 7, 8, 9, 10, 11, 12, 13, 14, 15, 17, 18, 19, 20, 21, 22, 23, 24, 25, 26, 27, 28, 29, 30, 31, 32, 33, 34, 35, 36, 37, 38, 39, 40, 41, 42, 43, 44, 45, 46, 47, 48, 49, 50, 51, 52, 53, 54, 55, 56, 57, 58, 59, 60, 61, 62, 63, 64, 65, 66, 67, 68, 69, 70, 71, 72, 74, 75, 76, 78, 79, 80, 81, 82, 83, 84, 85, 86, 87, 88, 90, 92, 93, 94, 96, 97, 98, 99, 100, 101, 103, 104, 106, 108, 110]"
GPUImage,19238,2199,1299,900,"[1, 2, 6, 7, 8, 9, 10, 11, 18, 20, 24, 25, 27, 29, 30, 34, 35, 36, 41, 42, 43, 44, 45, 46, 47, 48, 49, 50, 51, 52, 53, 54, 55, 56, 57, 59, 60, 61, 62, 63, 64, 65, 66, 67, 68, 69, 70, 71, 72, 74, 75, 76, 77, 78, 79, 80, 81, 82, 83, 84, 85, 86, 87, 88, 89, 91, 92, 93, 94, 95, 96, 97, 98, 99, 102, 103, 105, 106, 107, 108, 110, 111, 112, 113, 114, 117, 118, 119, 120, 121, 122, 123, 124, 126, 127, 128, 130, 131, 132, 133]"
guzzle,19228,1582,1354,228,"[1, 2, 3, 4, 6, 7, 8, 9, 10, 11, 12, 13, 14, 15, 16, 17, 18, 19, 20, 21, 22, 23, 24, 25, 27, 29, 31, 34, 35, 37, 39, 40, 41, 44, 45, 47, 52, 53, 55, 56, 57, 58, 63, 64, 65, 66, 67, 68, 70, 72, 73, 75, 76, 80, 81, 83, 85, 87, 88, 90, 91, 92, 95, 98, 99, 103, 104, 105, 107, 108, 111, 112, 113, 116, 120, 122, 124, 126, 127, 130, 135, 136, 138, 141, 143, 145, 148, 149, 154, 155, 158, 161, 166, 169, 170, 171, 172, 174, 180, 183]"
intro.js,19226,585,370,215,"[1, 2, 3, 4, 6, 10, 11, 12, 15, 25, 30, 31, 32, 33, 34, 35, 36, 38, 39, 40, 41, 43, 46, 48, 50, 52, 54, 55, 57, 58, 62, 63, 64, 66, 68, 69, 70, 71, 73, 74, 77, 78, 84, 88, 89, 90, 93, 94, 95, 96, 97, 98, 99, 100, 101, 102, 103, 104, 108, 109, 110, 113, 115, 117, 118, 119, 120, 122, 123, 125, 128, 129, 130, 132, 135, 136, 137, 138, 139, 142, 144, 145, 146, 148, 149, 151, 152, 153, 157, 158, 159, 162, 163, 165, 166, 167, 170, 172, 175, 178]"
HanLP,19219,1366,1359,7,"[1, 2, 3, 4, 5, 6, 7, 8, 9, 10, 11, 13, 15, 16, 17, 18, 19, 21, 22, 23, 24, 25, 26, 27, 28, 29, 30, 31, 32, 33, 34, 37, 38, 42, 43, 44, 45, 46, 49, 50, 51, 52, 53, 54, 55, 56, 57, 58, 59, 60, 61, 62, 63, 64, 65, 66, 67, 68, 69, 70, 71, 72, 73, 74, 75, 76, 82, 84, 85, 87, 89, 90, 91, 92, 93, 94, 95, 96, 97, 98, 99, 100, 101, 102, 103, 104, 105, 106, 107, 108, 109, 110, 111, 112, 113, 114, 115, 116, 117, 118]"
react-redux-links,19192,32,21,11,"[1, 8, 9, 11, 25, 26, 32, 44, 47, 48, 51, 53, 54, 58, 61, 62, 70, 71, 75, 77, 78, 81, 85, 87, 96, 98, 99, 101, 102, 106, 118, 126]"
pyenv,19187,1085,902,183,"[2, 3, 4, 5, 6, 7, 8, 9, 13, 14, 15, 16, 18, 19, 20, 21, 22, 23, 24, 25, 26, 27, 28, 29, 30, 31, 32, 33, 34, 35, 36, 38, 39, 40, 41, 42, 43, 46, 47, 48, 50, 51, 55, 56, 59, 60, 61, 62, 63, 64, 65, 66, 67, 68, 69, 70, 71, 72, 73, 74, 75, 76, 77, 78, 79, 81, 82, 84, 85, 86, 87, 89, 90, 91, 92, 93, 94, 95, 96, 97, 98, 99, 102, 103, 104, 105, 106, 107, 108, 109, 110, 111, 112, 115, 117, 120, 122, 124, 126, 127]"
pug,19183,2417,2200,217,"[1, 2, 3, 4, 5, 6, 7, 8, 9, 10, 11, 12, 13, 14, 15, 16, 17, 18, 19, 20, 21, 22, 23, 24, 25, 26, 27, 28, 29, 30, 31, 32, 33, 34, 35, 36, 37, 38, 39, 40, 41, 42, 43, 44, 45, 46, 47, 48, 49, 50, 51, 52, 53, 54, 55, 56, 57, 59, 60, 61, 62, 63, 64, 65, 66, 67, 68, 69, 70, 71, 72, 73, 74, 75, 77, 78, 79, 80, 81, 82, 83, 84, 85, 86, 87, 88, 89, 90, 91, 92, 93, 94, 95, 96, 97, 99, 100, 101, 102, 103]"
fonts,19155,223,81,142,"[1, 2, 8, 10, 11, 12, 17, 19, 20, 21, 22, 25, 29, 30, 31, 32, 34, 35, 39, 41, 42, 43, 44, 45, 48, 49, 50, 51, 54, 55, 56, 57, 58, 59, 60, 61, 62, 63, 64, 66, 67, 68, 69, 70, 71, 72, 75, 76, 77, 82, 86, 88, 92, 93, 94, 95, 96, 97, 98, 99, 100, 101, 103, 105, 106, 107, 109, 110, 112, 113, 114, 115, 117, 119, 121, 122, 123, 124, 125, 126, 132, 133, 135, 137, 138, 139, 142, 143, 144, 146, 147, 148, 149, 150, 151, 154, 155, 159, 160, 161]"
react-beautiful-dnd,19121,1035,845,190,"[1, 2, 3, 4, 5, 6, 7, 8, 9, 10, 11, 16, 17, 21, 24, 25, 27, 29, 33, 34, 35, 37, 38, 40, 44, 47, 49, 52, 54, 61, 62, 63, 64, 65, 68, 77, 78, 79, 83, 84, 86, 89, 91, 94, 97, 103, 107, 108, 109, 110, 114, 116, 118, 120, 121, 122, 126, 128, 129, 130, 131, 133, 134, 135, 136, 138, 139, 141, 142, 143, 144, 147, 149, 150, 153, 154, 155, 156, 157, 158, 159, 161, 162, 163, 164, 166, 167, 170, 171, 173, 174, 176, 177, 179, 180, 185, 188, 189, 190, 192]"
awesome-swift,19104,110,110,0,"[2, 12, 18, 27, 56, 94, 110, 142, 177, 262, 268, 279, 309, 311, 313, 342, 345, 347, 354, 397, 407, 448, 452, 477, 502, 531, 532, 535, 536, 558, 565, 571, 573, 574, 575, 578, 587, 615, 618, 624, 625, 666, 685, 687, 699, 720, 753, 758, 766, 771, 816, 818, 859, 863, 888, 891, 900, 906, 910, 914, 937, 947, 959, 993, 999, 1016, 1018, 1020, 1144, 1159, 1182, 1183, 1184, 1185, 1186, 1188, 1194, 1195, 1197, 1199, 1205, 1207, 1208, 1211, 1237, 1239, 1246, 1249, 1251, 1269, 1274, 1312, 1331, 1359, 1371, 1378, 1380, 1401, 1403, 1432]"
obs-studio,19091,441,344,97,"[3, 6, 9, 10, 11, 22, 36, 39, 40, 44, 46, 47, 48, 50, 51, 54, 58, 60, 61, 62, 66, 67, 73, 75, 76, 79, 80, 85, 91, 98, 103, 105, 107, 109, 115, 118, 119, 125, 127, 130, 143, 145, 147, 156, 158, 159, 163, 166, 167, 171, 173, 174, 176, 177, 178, 179, 182, 183, 184, 185, 186, 187, 192, 194, 196, 197, 198, 200, 201, 203, 204, 208, 209, 210, 213, 215, 216, 218, 220, 221, 222, 223, 225, 227, 228, 230, 231, 232, 236, 237, 238, 239, 241, 250, 255, 256, 257, 2157, 2158, 2159]"
bluebird,19082,1113,1057,56,"[1, 3, 5, 6, 7, 8, 9, 10, 11, 12, 14, 17, 20, 21, 22, 23, 24, 26, 27, 28, 30, 31, 32, 33, 34, 35, 36, 37, 41, 42, 43, 44, 45, 49, 50, 51, 52, 53, 54, 55, 56, 58, 60, 61, 62, 63, 64, 65, 66, 67, 70, 71, 72, 78, 79, 80, 81, 82, 83, 84, 85, 88, 89, 91, 92, 93, 96, 97, 100, 102, 103, 105, 106, 108, 109, 110, 111, 112, 113, 115, 116, 117, 118, 119, 122, 125, 126, 128, 131, 132, 133, 134, 135, 136, 137, 138, 139, 141, 142, 143]"
dokku,19072,2001,1965,36,"[2, 3, 4, 5, 6, 9, 11, 12, 13, 14, 15, 17, 19, 20, 22, 27, 28, 33, 35, 36, 39, 40, 43, 44, 46, 47, 48, 49, 51, 52, 53, 54, 55, 56, 57, 61, 63, 76, 78, 82, 83, 89, 90, 91, 92, 93, 97, 98, 100, 101, 103, 105, 107, 111, 112, 114, 115, 116, 117, 118, 119, 120, 123, 124, 125, 126, 128, 129, 130, 131, 135, 138, 141, 142, 144, 147, 148, 151, 152, 153, 155, 156, 157, 160, 161, 162, 163, 165, 171, 172, 174, 175, 176, 177, 181, 182, 183, 184, 185, 187]"
awesome-for-beginners,19071,57,55,2,"[2, 8, 14, 15, 33, 52, 63, 77, 86, 88, 97, 103, 113, 117, 122, 124, 125, 128, 153, 181, 182, 185, 192, 199, 203, 211, 215, 218, 219, 222, 235, 236, 281, 298, 306, 307, 315, 324, 325, 341, 352, 360, 362, 374, 428, 471, 590, 602, 609, 610, 614, 620, 634, 637, 640, 645, 646]"
profile-summary-for-github,19063,65,54,11,"[1, 2, 3, 4, 5, 6, 7, 8, 9, 10, 11, 12, 13, 14, 15, 16, 17, 18, 19, 20, 21, 22, 23, 25, 27, 28, 30, 32, 38, 39, 40, 41, 42, 43, 44, 45, 46, 47, 48, 49, 50, 51, 53, 54, 57, 61, 63, 70, 72, 73, 75, 77, 80, 82, 83, 87, 92, 95, 96, 97, 98, 99, 101, 102, 103]"
tornado,19061,1562,1397,165,"[1, 2, 3, 4, 5, 6, 7, 8, 9, 10, 11, 12, 13, 14, 15, 16, 17, 18, 19, 20, 21, 22, 23, 24, 25, 26, 27, 28, 29, 30, 31, 32, 33, 34, 35, 36, 37, 38, 39, 40, 41, 42, 43, 44, 45, 46, 47, 48, 49, 50, 51, 52, 53, 54, 55, 56, 57, 58, 59, 60, 61, 62, 63, 64, 65, 66, 67, 68, 69, 70, 71, 72, 73, 74, 75, 76, 77, 78, 79, 80, 81, 82, 83, 84, 85, 86, 87, 88, 89, 90, 92, 93, 94, 95, 96, 97, 98, 99, 100, 101]"
consul,19049,3720,3144,576,"[1, 2, 3, 4, 5, 6, 7, 8, 9, 10, 11, 12, 13, 14, 15, 16, 18, 22, 23, 24, 25, 29, 30, 33, 34, 39, 40, 41, 43, 48, 51, 54, 55, 57, 58, 59, 60, 61, 64, 65, 67, 69, 70, 71, 72, 73, 74, 75, 81, 82, 83, 84, 85, 86, 87, 90, 91, 92, 94, 95, 97, 99, 100, 101, 102, 104, 105, 106, 108, 109, 110, 111, 112, 114, 115, 118, 120, 121, 123, 125, 126, 130, 131, 132, 133, 134, 135, 137, 140, 141, 142, 143, 144, 147, 148, 149, 150, 151, 152, 153]"
gentelella,19039,617,604,13,"[1, 4, 5, 6, 8, 9, 10, 11, 13, 16, 17, 18, 19, 21, 22, 23, 24, 25, 27, 28, 29, 31, 33, 34, 35, 36, 39, 40, 41, 44, 45, 46, 47, 48, 49, 50, 51, 52, 53, 55, 58, 61, 62, 63, 65, 68, 69, 75, 78, 80, 82, 83, 86, 88, 90, 91, 92, 94, 95, 96, 97, 101, 107, 108, 112, 113, 114, 115, 116, 117, 119, 120, 121, 122, 123, 124, 125, 127, 128, 130, 131, 134, 135, 138, 139, 141, 142, 143, 147, 149, 150, 153, 154, 158, 160, 161, 168, 171, 175, 176]"
The-Art-Of-Programming-By-July,19036,127,82,45,"[3, 4, 10, 19, 20, 21, 22, 23, 25, 37, 41, 48, 50, 62, 63, 65, 71, 74, 78, 79, 80, 81, 84, 90, 122, 135, 137, 149, 156, 167, 169, 170, 171, 179, 182, 185, 204, 210, 213, 214, 224, 231, 232, 234, 248, 253, 255, 258, 262, 264, 269, 276, 282, 283, 284, 285, 286, 287, 289, 298, 307, 313, 314, 327, 330, 331, 334, 337, 338, 347, 348, 349, 360, 362, 363, 364, 366, 370, 377, 379, 380, 381, 385, 386, 389, 391, 392, 395, 396, 397, 402, 407, 412, 413, 416, 418, 419, 420, 422, 423]"
You-Dont-Need-jQuery,19034,64,57,7,"[3, 13, 14, 28, 31, 32, 33, 34, 35, 38, 42, 47, 55, 56, 73, 76, 82, 83, 85, 88, 92, 101, 113, 121, 123, 128, 135, 136, 137, 141, 144, 146, 157, 160, 163, 164, 165, 167, 169, 180, 185, 186, 187, 188, 189, 204, 205, 206, 207, 208, 210, 212, 213, 214, 215, 216, 220, 227, 230, 232, 235, 244, 245, 246]"
jsPDF,19013,1689,1487,202,"[1, 2, 4, 5, 8, 9, 10, 12, 13, 19, 20, 21, 22, 24, 26, 27, 28, 30, 32, 33, 34, 35, 36, 37, 38, 39, 40, 42, 43, 44, 45, 46, 47, 48, 49, 50, 51, 55, 56, 57, 58, 59, 62, 63, 64, 65, 66, 67, 68, 69, 70, 71, 72, 73, 76, 78, 79, 81, 86, 87, 88, 89, 90, 91, 92, 93, 95, 96, 97, 98, 99, 101, 102, 103, 107, 108, 109, 113, 114, 115, 116, 117, 118, 119, 121, 122, 123, 124, 125, 127, 128, 129, 130, 131, 132, 133, 136, 138, 139, 140]"
postwoman,19007,292,280,12,"[2, 4, 5, 8, 16, 17, 19, 26, 29, 30, 31, 32, 33, 36, 37, 38, 40, 41, 45, 46, 56, 57, 58, 60, 61, 62, 65, 66, 69, 70, 71, 74, 76, 77, 81, 87, 88, 91, 92, 93, 94, 97, 98, 99, 100, 102, 112, 113, 115, 122, 124, 128, 130, 133, 134, 139, 141, 147, 149, 155, 157, 158, 162, 164, 166, 167, 168, 175, 178, 180, 188, 190, 196, 203, 204, 206, 210, 212, 218, 225, 227, 229, 232, 233, 234, 235, 236, 237, 265, 266, 267, 268, 269, 271, 272, 274, 275, 277, 278, 279]"
PowerShell,19003,7408,4973,2435,"[1, 2, 4, 5, 20, 22, 23, 25, 26, 27, 28, 29, 30, 31, 32, 33, 34, 35, 36, 37, 38, 39, 40, 41, 42, 43, 44, 45, 46, 47, 48, 49, 50, 51, 52, 53, 54, 55, 56, 57, 58, 59, 60, 61, 62, 63, 64, 65, 66, 67, 68, 69, 70, 71, 72, 73, 74, 75, 76, 77, 78, 79, 80, 81, 82, 83, 84, 85, 86, 87, 88, 89, 90, 91, 92, 93, 94, 95, 96, 97, 98, 99, 100, 101, 102, 103, 104, 105, 106, 107, 108, 109, 110, 111, 112, 113, 114, 115, 116, 117]"
pandoc,18999,4994,4435,559,"[1, 2, 3, 4, 9, 10, 11, 13, 14, 15, 17, 18, 19, 20, 21, 22, 23, 24, 25, 26, 27, 28, 29, 30, 31, 32, 33, 34, 35, 36, 37, 38, 39, 40, 41, 42, 43, 44, 45, 46, 47, 48, 49, 50, 51, 52, 53, 54, 55, 56, 57, 58, 59, 60, 61, 62, 63, 64, 65, 66, 67, 68, 69, 70, 71, 72, 73, 74, 75, 76, 77, 78, 79, 80, 81, 82, 83, 84, 85, 86, 87, 88, 89, 90, 91, 92, 93, 94, 95, 96, 97, 98, 99, 100, 101, 102, 103, 104, 105, 106]"
emscripten,18995,5241,4622,619,"[1, 2, 3, 4, 5, 6, 7, 8, 9, 11, 12, 13, 14, 15, 16, 17, 18, 19, 20, 21, 22, 23, 24, 25, 28, 29, 30, 33, 34, 36, 38, 39, 40, 41, 42, 44, 46, 48, 49, 50, 51, 54, 55, 59, 60, 62, 64, 65, 66, 67, 69, 70, 72, 73, 77, 78, 80, 81, 82, 83, 84, 85, 87, 88, 89, 90, 91, 92, 93, 94, 96, 97, 99, 100, 102, 103, 104, 105, 108, 109, 112, 115, 117, 118, 120, 122, 123, 124, 127, 129, 131, 132, 133, 134, 137, 138, 139, 140, 141, 142]"
security-guide-for-developers,18985,11,4,7,"[14, 17, 20, 21, 24, 31, 35, 41, 44, 45, 55]"
awesome-python-cn,18968,14,9,5,"[4, 21, 26, 42, 44, 48, 49, 50, 68, 74, 83, 85, 86, 87]"
xgboost,18950,3403,3182,221,"[3, 4, 8, 9, 10, 11, 12, 13, 14, 15, 18, 20, 21, 22, 23, 25, 27, 28, 29, 30, 33, 40, 53, 54, 56, 57, 58, 60, 61, 62, 63, 64, 65, 68, 70, 73, 74, 75, 76, 77, 78, 79, 80, 81, 82, 83, 84, 85, 86, 87, 88, 89, 90, 91, 92, 93, 94, 95, 96, 97, 98, 99, 101, 102, 103, 104, 105, 107, 108, 109, 113, 114, 115, 116, 117, 118, 119, 120, 121, 122, 123, 126, 127, 141, 144, 147, 150, 151, 153, 154, 156, 157, 158, 159, 160, 161, 163, 164, 165, 166]"
RxAndroid,18920,336,336,0,"[1, 2, 3, 4, 5, 6, 7, 12, 14, 16, 18, 19, 21, 23, 24, 26, 28, 30, 31, 33, 34, 36, 37, 40, 44, 45, 47, 49, 50, 51, 54, 55, 58, 59, 62, 63, 65, 68, 69, 71, 72, 73, 74, 78, 79, 80, 83, 91, 94, 95, 98, 99, 101, 106, 108, 109, 110, 112, 113, 115, 117, 120, 125, 127, 128, 129, 130, 131, 132, 133, 134, 141, 144, 149, 150, 151, 153, 154, 155, 157, 158, 160, 161, 163, 164, 165, 167, 169, 170, 171, 172, 175, 178, 179, 181, 182, 183, 184, 185, 187]"
hosts,18894,378,334,44,"[1, 2, 3, 4, 5, 6, 7, 8, 9, 10, 11, 12, 13, 14, 15, 16, 17, 18, 19, 20, 22, 23, 24, 25, 26, 27, 28, 29, 30, 31, 32, 33, 34, 35, 36, 37, 38, 39, 40, 41, 42, 43, 44, 45, 46, 47, 48, 49, 50, 51, 52, 53, 54, 55, 56, 57, 58, 59, 60, 61, 62, 63, 64, 65, 66, 67, 68, 69, 70, 71, 72, 73, 74, 75, 76, 77, 78, 80, 81, 82, 83, 84, 85, 86, 87, 88, 89, 90, 91, 92, 93, 94, 95, 96, 97, 98, 99, 100, 101, 102]"
normalizr,18890,279,264,15,"[1, 3, 5, 6, 7, 8, 9, 10, 12, 15, 16, 17, 18, 19, 21, 23, 26, 28, 30, 32, 34, 36, 37, 38, 39, 40, 41, 44, 45, 47, 49, 50, 51, 54, 55, 58, 61, 62, 64, 65, 66, 67, 68, 70, 71, 74, 75, 76, 77, 78, 79, 81, 83, 85, 87, 88, 92, 93, 94, 95, 96, 98, 99, 101, 102, 103, 105, 106, 107, 108, 110, 111, 112, 113, 114, 116, 119, 120, 121, 122, 123, 124, 125, 126, 127, 129, 130, 131, 133, 134, 136, 137, 138, 140, 141, 142, 144, 146, 147, 148]"
react-virtualized,18890,957,683,274,"[1, 2, 6, 7, 18, 21, 22, 23, 24, 25, 26, 27, 29, 33, 34, 35, 36, 38, 40, 41, 44, 45, 47, 48, 50, 52, 53, 54, 55, 56, 59, 60, 66, 68, 69, 70, 72, 73, 74, 75, 80, 85, 86, 87, 88, 89, 92, 93, 94, 95, 99, 101, 102, 103, 104, 105, 106, 107, 109, 114, 115, 116, 118, 120, 121, 122, 123, 128, 131, 134, 135, 136, 138, 139, 140, 142, 143, 146, 147, 149, 150, 154, 156, 157, 160, 162, 165, 166, 167, 168, 171, 172, 174, 176, 178, 181, 182, 183, 186, 187]"
typeorm,18890,4694,3039,1655,"[1, 2, 3, 4, 5, 6, 9, 10, 11, 13, 15, 16, 18, 20, 22, 24, 25, 28, 30, 31, 32, 33, 34, 35, 36, 37, 38, 39, 40, 41, 42, 43, 46, 47, 48, 49, 51, 53, 54, 55, 56, 57, 58, 60, 61, 62, 63, 66, 67, 69, 70, 71, 72, 75, 77, 78, 79, 80, 81, 82, 84, 85, 86, 87, 88, 89, 90, 91, 94, 95, 96, 97, 98, 99, 101, 102, 103, 105, 106, 107, 108, 109, 110, 111, 113, 114, 115, 116, 118, 119, 121, 122, 123, 124, 125, 127, 128, 129, 130, 131]"
android-best-practices,18844,83,61,22,"[2, 3, 6, 8, 10, 11, 12, 13, 15, 21, 24, 25, 26, 27, 28, 30, 31, 32, 37, 41, 46, 48, 56, 59, 63, 64, 67, 69, 72, 75, 77, 78, 80, 81, 83, 84, 85, 88, 89, 90, 92, 93, 99, 106, 108, 111, 113, 114, 115, 116, 119, 120, 122, 125, 131, 133, 136, 148, 149, 150, 151, 152, 153, 154, 155, 156, 157, 158, 159, 160, 161, 162, 163, 164, 165, 167, 168, 171, 174, 177, 182, 187, 188]"
app-ideas,18834,18,7,11,"[17, 34, 40, 81, 111, 118, 126, 127, 138, 141, 148, 149, 150, 151, 154, 171, 173, 175]"
GitHub-Chinese-Top-Charts,18815,90,28,62,"[1, 2, 3, 4, 5, 6, 7, 8, 9, 12, 13, 14, 15, 17, 18, 19, 20, 21, 22, 23, 24, 25, 26, 27, 28, 29, 30, 31, 32, 33, 34, 35, 36, 37, 39, 40, 41, 42, 43, 45, 46, 47, 48, 49, 50, 51, 52, 53, 54, 55, 56, 57, 58, 59, 60, 61, 62, 63, 64, 65, 66, 67, 68, 69, 70, 77, 78, 79, 80, 81, 83, 84, 85, 86, 87, 88, 89, 90, 91, 93, 94, 95, 96, 97, 98, 99, 100, 101, 102, 103]"
husky,18804,496,369,127,"[1, 6, 7, 9, 10, 11, 12, 16, 18, 19, 20, 24, 25, 26, 27, 29, 33, 36, 38, 40, 43, 44, 46, 48, 49, 50, 52, 58, 59, 60, 61, 64, 65, 66, 68, 71, 72, 75, 76, 77, 78, 79, 80, 81, 84, 86, 87, 88, 92, 93, 94, 95, 96, 97, 98, 99, 102, 103, 105, 106, 108, 109, 110, 111, 112, 113, 115, 116, 117, 119, 120, 121, 123, 124, 125, 128, 129, 130, 131, 133, 134, 135, 136, 137, 139, 140, 141, 143, 144, 146, 148, 151, 153, 154, 155, 156, 157, 158, 159, 160]"
influxdb,18794,9805,9052,753,"[1, 2, 3, 4, 5, 6, 7, 8, 9, 10, 11, 12, 13, 14, 15, 16, 18, 21, 22, 23, 24, 25, 26, 27, 28, 29, 30, 31, 33, 34, 35, 36, 37, 38, 39, 40, 41, 42, 43, 44, 45, 46, 48, 49, 50, 51, 52, 53, 54, 55, 56, 59, 60, 61, 62, 63, 64, 65, 66, 67, 68, 69, 71, 73, 74, 75, 76, 77, 78, 79, 80, 81, 84, 85, 86, 87, 88, 89, 90, 91, 92, 93, 94, 95, 96, 97, 98, 99, 100, 101, 102, 103, 104, 105, 106, 107, 108, 109, 110, 111]"
ramda,18789,1436,1252,184,"[1, 2, 3, 4, 5, 6, 8, 9, 15, 17, 20, 25, 26, 27, 31, 37, 38, 40, 42, 43, 44, 47, 48, 49, 50, 51, 53, 54, 56, 59, 60, 62, 65, 66, 67, 78, 80, 81, 83, 84, 87, 96, 107, 111, 112, 120, 121, 129, 135, 139, 143, 144, 145, 147, 151, 164, 168, 169, 174, 175, 176, 177, 179, 180, 181, 182, 183, 184, 186, 188, 189, 191, 192, 208, 209, 210, 213, 215, 218, 219, 220, 222, 225, 230, 237, 240, 244, 245, 246, 249, 250, 251, 254, 255, 263, 267, 270, 272, 277, 286]"
vim-plug,18788,746,705,41,"[1, 2, 4, 5, 6, 7, 8, 9, 10, 11, 12, 14, 15, 17, 18, 19, 20, 21, 22, 23, 24, 25, 26, 27, 28, 29, 30, 31, 32, 33, 34, 35, 36, 38, 43, 48, 49, 50, 53, 54, 55, 56, 58, 59, 60, 61, 63, 64, 66, 68, 69, 70, 71, 72, 73, 74, 75, 76, 77, 78, 80, 81, 82, 83, 84, 85, 86, 87, 89, 90, 91, 92, 93, 94, 95, 96, 97, 98, 99, 100, 101, 102, 104, 105, 106, 107, 108, 109, 110, 111, 112, 113, 114, 115, 116, 117, 119, 120, 121, 122]"
How-to-Make-a-Computer-Operating-System,18758,63,25,38,"[2, 3, 8, 23, 28, 29, 33, 34, 39, 42, 43, 44, 46, 47, 48, 50, 53, 58, 59, 60, 61, 62, 63, 65, 66, 67, 68, 70, 71, 72, 77, 78, 80, 81, 82, 86, 89, 96, 97, 98, 99, 100, 107, 110, 116, 120, 125, 126, 127, 129, 130, 138, 142, 144, 145, 147, 148, 149, 151, 153, 154, 155, 161]"
955.WLB,18752,182,59,123,"[1, 2, 3, 4, 5, 6, 7, 10, 12, 13, 14, 15, 16, 17, 19, 20, 21, 22, 23, 24, 25, 26, 27, 29, 30, 31, 33, 34, 35, 36, 38, 39, 40, 41, 42, 43, 46, 47, 48, 49, 50, 51, 52, 53, 54, 55, 56, 57, 58, 61, 62, 63, 64, 65, 66, 67, 69, 70, 71, 72, 73, 74, 75, 76, 78, 79, 80, 81, 82, 83, 84, 85, 86, 87, 89, 90, 91, 92, 93, 94, 95, 96, 97, 98, 99, 100, 101, 102, 103, 104, 105, 106, 107, 108, 109, 110, 112, 113, 114, 115]"
enzyme,18710,1622,1403,219,"[2, 3, 4, 5, 6, 7, 8, 9, 10, 11, 12, 13, 15, 23, 26, 27, 29, 31, 32, 34, 39, 41, 43, 44, 45, 46, 47, 49, 51, 52, 55, 58, 61, 64, 66, 67, 68, 69, 73, 75, 76, 78, 79, 80, 82, 83, 84, 86, 88, 89, 91, 94, 97, 98, 99, 102, 104, 105, 108, 111, 112, 113, 116, 118, 119, 120, 122, 123, 127, 128, 132, 134, 136, 138, 139, 142, 143, 144, 145, 146, 147, 151, 153, 157, 161, 163, 164, 165, 166, 167, 168, 169, 173, 175, 177, 179, 180, 182, 183, 184]"
scrollreveal,18678,453,444,9,"[1, 2, 5, 8, 9, 10, 12, 13, 14, 15, 17, 18, 19, 20, 23, 24, 26, 29, 30, 31, 32, 34, 36, 39, 40, 41, 42, 43, 44, 45, 47, 48, 49, 50, 51, 52, 53, 54, 57, 58, 59, 60, 61, 62, 63, 64, 65, 66, 67, 69, 70, 72, 73, 74, 75, 76, 77, 78, 79, 80, 81, 82, 83, 84, 85, 86, 87, 88, 89, 91, 92, 93, 94, 95, 96, 97, 98, 100, 101, 102, 103, 104, 105, 106, 107, 108, 109, 110, 111, 112, 113, 114, 115, 116, 117, 118, 120, 121, 122, 123]"
mitmproxy,18670,2192,1935,257,"[1, 3, 5, 6, 10, 13, 16, 17, 18, 19, 20, 23, 24, 25, 26, 27, 28, 30, 31, 37, 38, 39, 40, 44, 45, 47, 49, 50, 55, 58, 63, 64, 65, 66, 67, 68, 70, 71, 72, 73, 76, 77, 79, 84, 86, 87, 88, 89, 90, 95, 96, 97, 102, 103, 104, 105, 108, 109, 110, 111, 114, 115, 117, 120, 121, 122, 123, 125, 126, 127, 128, 130, 133, 135, 140, 141, 144, 145, 146, 147, 149, 150, 151, 152, 153, 154, 155, 156, 157, 158, 160, 163, 165, 167, 169, 171, 172, 174, 175, 176]"
DesignPatternsPHP,18660,93,90,3,"[1, 4, 5, 6, 12, 22, 26, 31, 34, 41, 47, 66, 75, 78, 88, 89, 105, 110, 112, 114, 124, 134, 142, 155, 167, 171, 175, 181, 186, 190, 193, 209, 215, 216, 218, 219, 225, 227, 232, 234, 242, 250, 251, 253, 254, 257, 258, 261, 264, 265, 267, 268, 279, 282, 283, 284, 286, 288, 292, 296, 298, 299, 304, 307, 313, 315, 320, 328, 332, 333, 334, 335, 339, 342, 343, 345, 346, 347, 348, 350, 352, 363, 367, 369, 370, 371, 373, 376, 377, 385, 386, 387, 388]"
cheat.sh,18653,115,56,59,"[1, 2, 3, 5, 6, 7, 8, 13, 14, 18, 22, 23, 24, 26, 28, 29, 31, 32, 34, 39, 40, 41, 44, 45, 46, 47, 50, 52, 56, 59, 60, 62, 63, 65, 67, 68, 69, 70, 71, 73, 74, 76, 77, 78, 80, 81, 82, 83, 86, 87, 88, 95, 97, 98, 107, 109, 112, 113, 114, 115, 117, 118, 119, 120, 121, 123, 124, 127, 129, 133, 134, 135, 137, 138, 139, 140, 141, 144, 145, 146, 147, 148, 149, 150, 151, 153, 154, 155, 156, 157, 158, 159, 160, 161, 162, 164, 165, 166, 167, 168]"
incubator-mxnet,18648,8879,7192,1687,"[40, 41, 52, 56, 61, 66, 110, 111, 148, 150, 151, 152, 153, 154, 169, 177, 182, 184, 185, 186, 188, 189, 192, 194, 198, 199, 206, 207, 212, 214, 219, 223, 227, 231, 235, 240, 242, 244, 245, 248, 249, 250, 252, 255, 260, 262, 265, 266, 267, 269, 270, 273, 279, 282, 283, 286, 287, 288, 295, 297, 309, 314, 320, 324, 325, 328, 329, 331, 332, 335, 336, 337, 338, 340, 341, 344, 347, 348, 349, 352, 354, 359, 362, 364, 365, 369, 371, 375, 376, 377, 378, 379, 380, 381, 384, 386, 389, 391, 394, 397]"
vapor,18600,1248,1208,40,"[1, 3, 4, 5, 6, 7, 10, 11, 12, 18, 20, 21, 22, 23, 24, 27, 28, 32, 37, 41, 42, 43, 44, 51, 59, 70, 84, 85, 87, 93, 96, 105, 106, 108, 109, 110, 111, 112, 113, 115, 121, 126, 127, 128, 129, 144, 157, 158, 166, 168, 169, 170, 173, 177, 178, 181, 183, 184, 185, 188, 190, 192, 193, 194, 195, 198, 203, 204, 212, 213, 214, 215, 216, 217, 219, 220, 224, 225, 226, 227, 228, 230, 231, 234, 240, 242, 243, 244, 245, 246, 247, 248, 249, 250, 251, 254, 255, 256, 257, 259]"
web-starter-kit,18563,580,533,47,"[1, 2, 3, 4, 5, 6, 7, 8, 9, 11, 12, 17, 18, 19, 20, 21, 23, 25, 28, 29, 30, 31, 32, 33, 34, 35, 36, 39, 40, 41, 42, 43, 46, 48, 50, 51, 52, 53, 54, 57, 59, 60, 63, 64, 65, 68, 71, 73, 74, 76, 77, 78, 79, 82, 84, 86, 88, 91, 93, 94, 96, 97, 99, 100, 101, 102, 112, 115, 116, 117, 121, 122, 123, 132, 133, 136, 137, 139, 143, 144, 146, 148, 149, 150, 155, 156, 157, 159, 160, 162, 163, 164, 165, 166, 168, 169, 170, 174, 175, 176]"
react-native-elements,18557,1414,1328,86,"[1, 4, 5, 9, 10, 12, 15, 16, 19, 20, 21, 22, 25, 26, 27, 28, 29, 30, 32, 34, 36, 37, 38, 39, 41, 42, 43, 44, 47, 48, 49, 50, 51, 52, 55, 56, 57, 61, 64, 65, 66, 67, 69, 70, 71, 72, 74, 76, 77, 78, 80, 81, 82, 84, 85, 86, 88, 90, 91, 92, 94, 95, 96, 97, 98, 99, 100, 101, 102, 104, 105, 106, 107, 108, 109, 110, 112, 113, 114, 115, 116, 117, 118, 119, 120, 121, 122, 123, 124, 125, 126, 128, 129, 130, 132, 133, 135, 136, 137, 138]"
ngrok,18542,591,371,220,"[3, 4, 6, 7, 8, 11, 12, 13, 14, 16, 19, 20, 21, 22, 23, 24, 25, 26, 27, 28, 29, 30, 31, 32, 36, 37, 38, 39, 40, 41, 42, 43, 44, 45, 47, 49, 50, 53, 54, 55, 56, 57, 58, 59, 61, 62, 63, 64, 65, 66, 67, 68, 69, 71, 72, 75, 76, 77, 80, 81, 83, 84, 86, 87, 88, 89, 91, 92, 93, 94, 97, 98, 99, 100, 101, 102, 104, 105, 106, 107, 108, 109, 110, 111, 112, 113, 115, 116, 117, 118, 119, 120, 121, 122, 123, 124, 125, 126, 127, 129]"
docz,18521,1055,984,71,"[1, 3, 5, 6, 8, 9, 10, 11, 12, 14, 15, 16, 18, 19, 20, 21, 22, 23, 24, 25, 26, 27, 28, 29, 30, 32, 33, 34, 35, 36, 37, 39, 40, 41, 42, 43, 44, 45, 46, 47, 48, 49, 51, 53, 55, 56, 57, 58, 59, 61, 62, 64, 65, 66, 67, 68, 69, 71, 72, 75, 76, 77, 79, 80, 82, 83, 84, 85, 91, 92, 96, 98, 100, 104, 108, 109, 110, 111, 112, 114, 115, 117, 118, 120, 121, 122, 123, 124, 125, 126, 127, 128, 129, 130, 131, 132, 133, 134, 135, 136]"
NativeScript,18492,5622,4994,628,"[2, 3, 4, 5, 6, 7, 8, 9, 10, 11, 12, 13, 14, 15, 16, 17, 18, 19, 20, 21, 22, 23, 24, 25, 26, 27, 28, 29, 30, 31, 32, 33, 34, 35, 36, 37, 38, 39, 40, 41, 42, 43, 44, 45, 46, 47, 48, 49, 50, 51, 52, 53, 54, 55, 56, 57, 58, 59, 60, 61, 62, 63, 64, 65, 66, 67, 68, 69, 70, 71, 72, 73, 74, 75, 76, 77, 78, 79, 83, 85, 86, 91, 92, 94, 95, 96, 98, 99, 101, 103, 104, 105, 106, 107, 108, 109, 110, 111, 113, 114]"
data-science-ipython-notebooks,18403,27,19,8,"[1, 2, 3, 4, 5, 6, 8, 9, 10, 11, 12, 13, 16, 17, 21, 25, 33, 39, 45, 49, 50, 59, 60, 61, 64, 69, 70]"
skrollr,18400,776,533,243,"[1, 2, 3, 4, 5, 6, 7, 8, 9, 11, 12, 13, 14, 16, 17, 19, 20, 21, 22, 23, 24, 25, 26, 27, 28, 29, 30, 32, 33, 34, 35, 36, 37, 38, 39, 40, 41, 43, 45, 46, 47, 48, 49, 50, 51, 52, 53, 54, 56, 57, 58, 59, 60, 61, 62, 63, 64, 65, 66, 67, 68, 69, 70, 71, 72, 73, 74, 75, 76, 77, 78, 79, 80, 81, 82, 83, 84, 85, 86, 87, 88, 89, 90, 91, 92, 93, 95, 96, 97, 98, 99, 101, 102, 104, 105, 106, 107, 108, 109, 110]"
autoprefixer,18387,1016,995,21,"[2, 3, 4, 6, 7, 8, 9, 11, 12, 14, 15, 16, 17, 18, 19, 20, 21, 22, 23, 24, 25, 26, 27, 28, 29, 31, 32, 33, 34, 35, 36, 37, 38, 39, 40, 41, 42, 43, 44, 46, 49, 50, 51, 54, 56, 57, 58, 61, 62, 63, 64, 65, 66, 67, 68, 69, 70, 71, 73, 74, 76, 77, 78, 80, 81, 83, 84, 85, 86, 88, 89, 91, 92, 93, 94, 95, 96, 97, 98, 100, 101, 103, 104, 106, 107, 108, 109, 110, 111, 112, 113, 114, 115, 119, 120, 121, 122, 123, 126, 128]"
Daily-Interview-Question,18382,347,196,151,"[1, 3, 4, 5, 6, 7, 8, 9, 10, 11, 12, 14, 15, 16, 17, 18, 19, 20, 21, 22, 23, 24, 25, 26, 27, 28, 29, 30, 31, 32, 33, 34, 35, 36, 39, 41, 42, 43, 44, 45, 47, 48, 51, 52, 53, 54, 55, 56, 57, 58, 59, 60, 61, 63, 64, 65, 66, 67, 68, 69, 70, 71, 72, 73, 74, 75, 76, 79, 80, 81, 82, 84, 85, 86, 87, 88, 89, 90, 91, 92, 93, 94, 95, 96, 97, 98, 99, 100, 101, 102, 103, 104, 105, 106, 107, 108, 109, 110, 111, 112]"
RxSwift,18368,1049,1021,28,"[2, 4, 5, 10, 20, 23, 24, 27, 33, 34, 35, 36, 38, 40, 42, 43, 45, 46, 53, 56, 57, 58, 59, 60, 65, 67, 68, 69, 73, 74, 79, 80, 81, 82, 86, 88, 89, 91, 93, 95, 99, 101, 102, 106, 108, 109, 110, 120, 121, 122, 123, 124, 125, 126, 127, 128, 130, 132, 133, 141, 143, 144, 150, 151, 152, 160, 161, 170, 174, 177, 180, 181, 186, 187, 188, 192, 193, 199, 201, 206, 208, 209, 210, 215, 217, 219, 224, 226, 228, 229, 230, 231, 232, 234, 235, 236, 239, 240, 241, 247]"
js-stack-from-scratch,18344,156,118,38,"[1, 2, 3, 4, 6, 10, 11, 14, 19, 23, 30, 31, 32, 34, 35, 36, 37, 38, 39, 43, 47, 48, 50, 52, 53, 55, 56, 58, 60, 64, 67, 69, 70, 72, 73, 78, 80, 81, 84, 85, 86, 87, 88, 90, 92, 93, 95, 96, 98, 99, 103, 106, 107, 109, 110, 111, 118, 119, 120, 122, 123, 125, 127, 128, 132, 133, 134, 136, 137, 138, 139, 141, 142, 143, 144, 145, 147, 148, 149, 150, 151, 152, 153, 154, 155, 156, 157, 159, 160, 161, 162, 165, 167, 168, 170, 171, 172, 173, 174, 175]"
json,18331,1605,1573,32,"[1, 2, 3, 4, 7, 8, 9, 10, 11, 12, 13, 15, 16, 17, 20, 25, 27, 28, 30, 31, 32, 37, 39, 42, 43, 44, 45, 46, 47, 48, 49, 50, 51, 52, 53, 54, 55, 56, 57, 58, 60, 61, 62, 64, 65, 66, 67, 68, 70, 76, 77, 78, 80, 82, 83, 84, 89, 90, 91, 92, 93, 94, 95, 96, 97, 98, 99, 100, 101, 102, 103, 106, 107, 108, 109, 110, 112, 113, 114, 117, 118, 125, 127, 128, 132, 133, 134, 135, 136, 138, 144, 145, 147, 148, 149, 150, 151, 152, 154, 156]"
Hero,18329,541,372,169,"[1, 2, 7, 8, 9, 10, 11, 14, 17, 19, 21, 24, 25, 26, 27, 29, 31, 32, 34, 35, 36, 37, 38, 40, 42, 44, 45, 47, 48, 50, 51, 53, 54, 55, 56, 58, 59, 60, 61, 62, 63, 64, 65, 67, 68, 69, 70, 72, 73, 74, 75, 76, 77, 79, 80, 81, 82, 84, 85, 86, 87, 88, 89, 90, 91, 92, 94, 95, 96, 97, 98, 99, 100, 101, 102, 103, 104, 105, 106, 107, 108, 109, 110, 111, 112, 113, 114, 116, 117, 118, 119, 120, 121, 122, 123, 124, 125, 126, 127, 128]"
nightmare,18289,1204,1056,148,"[1, 2, 3, 5, 7, 9, 10, 11, 12, 13, 18, 19, 20, 21, 22, 23, 24, 26, 29, 32, 33, 35, 36, 37, 38, 39, 40, 42, 44, 45, 46, 47, 48, 49, 50, 53, 55, 60, 61, 64, 70, 75, 79, 80, 81, 83, 85, 86, 88, 89, 90, 91, 92, 96, 98, 102, 103, 104, 105, 106, 107, 108, 113, 114, 116, 117, 118, 119, 120, 123, 124, 126, 127, 128, 129, 130, 131, 132, 134, 136, 140, 141, 142, 143, 144, 146, 147, 148, 149, 150, 151, 152, 155, 156, 157, 159, 162, 163, 165, 166]"
react-motion,18276,386,241,145,"[5, 9, 10, 11, 12, 14, 15, 16, 20, 21, 24, 26, 29, 31, 33, 34, 36, 37, 38, 41, 44, 45, 54, 55, 58, 59, 60, 61, 62, 63, 65, 66, 67, 68, 69, 70, 72, 73, 75, 77, 79, 80, 83, 84, 85, 86, 87, 88, 89, 90, 91, 93, 95, 98, 100, 101, 104, 106, 109, 113, 114, 124, 125, 129, 130, 132, 133, 135, 136, 137, 139, 140, 142, 144, 147, 149, 150, 151, 153, 154, 155, 156, 157, 158, 159, 160, 161, 162, 163, 164, 165, 166, 167, 168, 169, 170, 171, 172, 175, 178]"
javascript-questions,18257,106,79,27,"[1, 3, 4, 5, 8, 10, 11, 12, 14, 16, 19, 21, 22, 23, 25, 26, 27, 33, 35, 37, 38, 40, 41, 42, 44, 45, 49, 50, 51, 52, 55, 56, 57, 58, 59, 61, 65, 66, 79, 82, 83, 104, 105, 112, 116, 117, 118, 121, 122, 124, 127, 134, 137, 139, 151, 152, 155, 157, 162, 163, 166, 180, 181, 183, 190, 191, 193, 196, 209, 210, 218, 219, 220, 227, 233, 234, 242, 243, 245, 249, 262, 265, 271, 272, 277, 278, 279, 291, 298, 299, 301, 305, 307, 320, 323, 324, 330, 331, 333, 343]"
docker-cheat-sheet,18246,26,21,5,"[1, 6, 8, 14, 39, 42, 44, 48, 59, 73, 81, 100, 101, 111, 114, 124, 143, 148, 151, 152, 154, 155, 173, 174, 178, 180]"
Blog,18220,165,78,87,"[1, 2, 3, 4, 5, 6, 7, 8, 9, 10, 11, 12, 13, 14, 15, 16, 17, 18, 19, 20, 21, 22, 23, 24, 25, 26, 27, 28, 29, 30, 31, 32, 33, 34, 35, 36, 37, 38, 39, 40, 41, 42, 43, 44, 45, 46, 47, 48, 49, 50, 51, 52, 53, 54, 55, 56, 57, 58, 59, 60, 61, 62, 63, 64, 65, 66, 70, 71, 72, 73, 74, 75, 76, 77, 78, 79, 80, 81, 82, 83, 84, 85, 86, 87, 88, 89, 90, 91, 92, 93, 94, 96, 97, 98, 99, 100, 101, 102, 103, 105]"
gorm,18198,2415,1777,638,"[1, 2, 3, 4, 5, 6, 7, 8, 9, 10, 11, 12, 13, 14, 15, 16, 17, 18, 20, 21, 23, 24, 25, 26, 27, 29, 30, 31, 35, 36, 37, 38, 39, 40, 42, 44, 45, 47, 48, 49, 50, 51, 52, 53, 54, 55, 56, 57, 58, 59, 60, 61, 62, 63, 65, 66, 68, 69, 71, 72, 73, 74, 75, 78, 79, 80, 81, 82, 83, 84, 88, 93, 94, 95, 96, 97, 99, 100, 101, 102, 106, 107, 108, 109, 110, 111, 113, 114, 115, 116, 117, 118, 119, 120, 121, 122, 123, 125, 126, 128]"
awesome-remote-job,18187,36,34,2,"[48, 50, 58, 59, 60, 69, 70, 71, 72, 100, 106, 123, 175, 178, 180, 183, 191, 228, 249, 251, 252, 312, 314, 334, 338, 347, 356, 358, 366, 395, 419, 476, 557, 570, 578, 627]"
algo,18154,1258,1191,67,"[1, 2, 3, 4, 5, 6, 7, 8, 9, 10, 11, 12, 13, 14, 15, 16, 17, 18, 19, 20, 21, 22, 23, 24, 25, 26, 27, 28, 29, 30, 33, 34, 35, 36, 37, 39, 40, 42, 43, 44, 45, 46, 48, 49, 50, 51, 52, 53, 54, 56, 57, 58, 59, 60, 61, 62, 63, 64, 65, 66, 67, 68, 70, 71, 72, 73, 74, 75, 76, 77, 78, 79, 80, 81, 82, 83, 84, 85, 86, 87, 88, 89, 90, 91, 92, 93, 94, 95, 96, 97, 98, 99, 100, 102, 103, 104, 105, 106, 107, 108]"
cockroach,18141,24506,21527,2979,"[14, 17, 18, 19, 20, 21, 22, 23, 24, 25, 26, 27, 28, 29, 31, 34, 35, 36, 37, 38, 39, 40, 53, 54, 61, 78, 84, 94, 99, 104, 156, 163, 168, 175, 182, 200, 201, 205, 220, 222, 226, 227, 228, 229, 230, 231, 232, 235, 236, 237, 243, 248, 251, 260, 268, 270, 281, 285, 287, 307, 309, 313, 315, 325, 326, 335, 343, 352, 357, 393, 420, 426, 428, 435, 437, 460, 465, 469, 472, 473, 479, 480, 493, 494, 498, 501, 507, 508, 515, 520, 522, 523, 525, 527, 531, 532, 534, 543, 544, 545]"
minikube,18138,4279,3857,422,"[1, 2, 3, 4, 5, 6, 7, 8, 10, 11, 12, 13, 14, 15, 16, 17, 18, 28, 29, 33, 35, 38, 40, 46, 47, 49, 50, 51, 52, 53, 55, 56, 58, 59, 64, 65, 68, 69, 70, 83, 84, 85, 87, 91, 92, 93, 94, 99, 101, 105, 114, 116, 117, 118, 123, 129, 130, 135, 136, 137, 140, 141, 156, 160, 162, 168, 171, 172, 176, 177, 178, 185, 187, 189, 192, 197, 198, 199, 201, 202, 203, 208, 209, 211, 212, 213, 214, 215, 216, 217, 220, 221, 222, 223, 227, 228, 235, 236, 237, 238]"
mattermost-server,18133,4619,4246,373,"[53, 57, 58, 60, 61, 63, 64, 68, 69, 70, 71, 78, 80, 84, 85, 86, 88, 89, 95, 96, 97, 104, 112, 113, 119, 129, 144, 169, 172, 173, 179, 187, 190, 263, 286, 308, 314, 336, 339, 355, 357, 361, 396, 402, 411, 426, 454, 461, 462, 479, 483, 530, 533, 540, 546, 574, 578, 603, 604, 606, 619, 620, 637, 642, 643, 650, 652, 667, 669, 670, 689, 698, 707, 711, 721, 726, 727, 728, 735, 738, 745, 773, 786, 790, 796, 804, 814, 822, 826, 827, 828, 829, 834, 835, 842, 844, 847, 868, 870, 871]"
waifu2x,18122,263,160,103,"[1, 2, 3, 4, 5, 6, 7, 8, 9, 11, 12, 13, 14, 16, 17, 20, 22, 23, 24, 25, 27, 29, 30, 31, 34, 35, 36, 37, 40, 41, 45, 47, 50, 51, 52, 53, 54, 55, 56, 57, 60, 61, 63, 65, 66, 69, 70, 72, 73, 75, 76, 77, 80, 81, 82, 83, 85, 87, 88, 89, 90, 91, 92, 93, 94, 96, 99, 105, 106, 107, 108, 109, 110, 113, 114, 117, 118, 119, 121, 122, 125, 126, 128, 129, 131, 132, 133, 134, 135, 136, 139, 141, 143, 144, 145, 146, 147, 148, 149, 150]"
rollup,18110,2247,2061,186,"[1, 2, 5, 10, 11, 12, 13, 14, 15, 16, 18, 20, 21, 22, 23, 24, 25, 26, 28, 29, 30, 32, 33, 34, 36, 37, 39, 42, 44, 45, 50, 51, 52, 53, 55, 57, 59, 61, 67, 68, 69, 72, 74, 75, 76, 77, 80, 81, 82, 83, 88, 91, 92, 96, 100, 101, 104, 105, 106, 107, 108, 112, 115, 116, 119, 120, 121, 123, 125, 126, 128, 131, 132, 133, 136, 139, 140, 143, 144, 145, 146, 148, 149, 153, 154, 157, 158, 164, 166, 168, 171, 178, 179, 182, 185, 186, 189, 191, 192, 193]"
iris,18074,536,521,15,"[674, 675, 676, 677, 678, 680, 681, 683, 685, 686, 687, 688, 692, 694, 696, 698, 701, 702, 703, 704, 706, 710, 711, 714, 715, 717, 718, 719, 721, 723, 724, 725, 726, 729, 730, 732, 737, 740, 741, 742, 745, 746, 748, 749, 750, 751, 752, 754, 756, 757, 759, 761, 762, 763, 764, 766, 767, 768, 771, 772, 777, 778, 781, 782, 784, 785, 786, 787, 789, 791, 793, 796, 798, 799, 803, 805, 807, 809, 810, 814, 815, 820, 821, 822, 823, 825, 827, 829, 830, 832, 833, 834, 835, 836, 837, 838, 840, 841, 842, 846]"
es6tutorial,18061,467,467,0,"[1, 5, 7, 9, 13, 14, 15, 16, 17, 18, 19, 20, 21, 22, 23, 24, 25, 27, 28, 29, 30, 31, 33, 36, 37, 38, 43, 46, 47, 49, 56, 62, 63, 64, 74, 75, 76, 77, 81, 83, 85, 88, 89, 94, 97, 98, 102, 103, 106, 108, 111, 113, 115, 116, 117, 128, 139, 140, 141, 145, 146, 148, 150, 155, 156, 160, 162, 166, 171, 174, 175, 176, 178, 179, 182, 191, 211, 219, 220, 221, 222, 230, 233, 236, 237, 240, 243, 245, 246, 247, 251, 252, 253, 258, 259, 261, 265, 267, 271, 273]"
CodeIgniter,18049,3108,3051,57,"[1, 2, 3, 4, 5, 6, 7, 8, 9, 10, 11, 12, 13, 14, 15, 16, 17, 18, 19, 20, 21, 22, 23, 24, 25, 26, 27, 28, 29, 30, 31, 32, 33, 34, 35, 36, 37, 38, 39, 40, 41, 42, 43, 44, 45, 46, 47, 48, 49, 50, 51, 52, 53, 54, 55, 56, 57, 58, 59, 60, 61, 62, 63, 64, 65, 66, 67, 68, 69, 70, 71, 72, 73, 74, 75, 76, 77, 78, 79, 80, 81, 82, 83, 84, 85, 86, 87, 88, 89, 90, 91, 92, 93, 94, 95, 96, 97, 98, 99, 100]"
fastclick,18048,389,179,210,"[1, 2, 3, 4, 6, 7, 10, 12, 13, 14, 15, 16, 17, 18, 19, 20, 21, 22, 23, 24, 25, 26, 27, 30, 32, 33, 36, 37, 40, 41, 42, 43, 44, 45, 47, 48, 49, 50, 51, 52, 53, 54, 55, 56, 57, 60, 61, 62, 63, 64, 65, 66, 67, 68, 71, 73, 74, 75, 76, 77, 79, 80, 81, 82, 83, 84, 86, 87, 89, 90, 91, 92, 95, 96, 97, 98, 104, 106, 107, 108, 109, 110, 111, 112, 113, 115, 116, 117, 118, 119, 120, 121, 123, 124, 125, 127, 129, 130, 131, 132]"
react-navigation,18046,6848,6707,141,"[4, 5, 6, 8, 9, 11, 12, 13, 14, 15, 16, 18, 21, 27, 28, 30, 31, 33, 34, 36, 37, 38, 40, 42, 47, 48, 49, 50, 51, 52, 53, 54, 55, 58, 59, 60, 61, 62, 63, 64, 66, 67, 68, 70, 71, 72, 73, 74, 75, 76, 77, 78, 80, 81, 82, 83, 84, 85, 86, 87, 88, 90, 91, 93, 94, 95, 98, 100, 104, 108, 110, 113, 115, 116, 117, 119, 123, 124, 125, 126, 127, 129, 131, 133, 135, 136, 138, 139, 140, 141, 142, 143, 145, 146, 147, 148, 149, 153, 154, 155]"
feather,17985,457,191,266,"[1, 3, 4, 5, 6, 7, 8, 9, 11, 12, 13, 14, 15, 16, 17, 18, 19, 20, 21, 22, 23, 24, 25, 26, 27, 28, 29, 30, 31, 32, 33, 35, 36, 37, 38, 39, 40, 41, 42, 43, 44, 45, 47, 48, 49, 50, 51, 52, 53, 54, 55, 56, 57, 58, 59, 60, 61, 62, 63, 64, 65, 67, 68, 69, 70, 71, 72, 74, 75, 76, 77, 79, 81, 84, 85, 86, 88, 89, 90, 91, 92, 93, 94, 95, 96, 97, 98, 99, 100, 101, 102, 103, 104, 105, 106, 108, 109, 110, 112, 113]"
mostly-adequate-guide,17975,224,183,41,"[6, 10, 12, 19, 32, 37, 38, 39, 48, 50, 51, 54, 55, 56, 59, 60, 62, 63, 67, 76, 77, 80, 82, 83, 84, 98, 105, 106, 108, 109, 112, 113, 114, 116, 121, 122, 124, 125, 126, 128, 129, 130, 131, 133, 139, 144, 146, 148, 149, 150, 155, 160, 161, 163, 165, 167, 168, 169, 170, 174, 175, 176, 183, 185, 186, 187, 192, 193, 194, 195, 198, 200, 202, 205, 208, 210, 213, 214, 216, 217, 219, 220, 221, 222, 223, 233, 238, 239, 241, 244, 245, 246, 250, 254, 255, 256, 257, 261, 262, 264]"
draft-js,17961,1491,894,597,"[1, 7, 10, 13, 14, 19, 26, 27, 28, 32, 33, 34, 35, 36, 39, 40, 41, 42, 43, 45, 46, 47, 49, 50, 51, 52, 53, 54, 55, 58, 60, 61, 62, 63, 65, 68, 69, 73, 74, 75, 77, 79, 81, 83, 84, 85, 86, 87, 88, 90, 91, 92, 93, 95, 97, 99, 100, 101, 102, 103, 104, 105, 107, 108, 109, 112, 113, 117, 119, 120, 121, 122, 124, 125, 126, 127, 128, 129, 132, 133, 136, 137, 138, 140, 141, 142, 143, 146, 147, 148, 149, 150, 151, 152, 153, 154, 155, 160, 161, 162]"
corefx,17891,0,0,0,[]
ava,17869,1347,1195,152,"[1, 2, 3, 4, 5, 6, 7, 8, 9, 10, 11, 12, 13, 14, 15, 16, 17, 18, 19, 20, 21, 22, 24, 25, 27, 28, 31, 32, 34, 35, 37, 38, 40, 45, 48, 50, 53, 54, 55, 60, 62, 63, 68, 70, 73, 74, 75, 77, 78, 80, 83, 84, 85, 86, 87, 89, 92, 94, 95, 96, 97, 100, 102, 104, 105, 107, 108, 109, 111, 112, 113, 114, 115, 116, 117, 118, 121, 122, 123, 128, 129, 130, 131, 132, 133, 137, 138, 139, 140, 141, 142, 143, 144, 145, 148, 149, 152, 154, 156, 157]"
mongo,17839,0,0,0,[]
fastai,17801,1029,1026,3,"[1, 4, 6, 7, 23, 32, 33, 51, 59, 65, 70, 71, 72, 73, 74, 77, 79, 82, 84, 86, 87, 88, 94, 96, 103, 104, 107, 111, 114, 115, 116, 117, 121, 122, 125, 129, 131, 133, 134, 136, 137, 139, 140, 141, 143, 152, 153, 155, 162, 163, 179, 184, 186, 189, 192, 193, 194, 196, 200, 201, 203, 205, 206, 213, 215, 217, 219, 220, 225, 227, 236, 240, 241, 245, 252, 261, 264, 267, 271, 279, 282, 286, 287, 319, 321, 333, 344, 349, 355, 368, 371, 372, 373, 375, 376, 386, 389, 391, 392, 397]"
gson,17763,1261,849,412,"[1, 2, 3, 4, 5, 6, 7, 8, 9, 10, 11, 12, 13, 14, 15, 16, 17, 18, 19, 20, 21, 22, 23, 24, 25, 26, 27, 28, 29, 30, 31, 32, 33, 34, 35, 36, 37, 38, 39, 40, 41, 42, 43, 44, 45, 46, 47, 48, 49, 50, 51, 52, 53, 54, 55, 56, 57, 58, 59, 60, 61, 62, 63, 64, 65, 66, 67, 68, 69, 70, 71, 72, 73, 74, 75, 76, 77, 78, 79, 80, 81, 82, 83, 84, 85, 86, 87, 88, 89, 90, 91, 92, 93, 94, 95, 96, 97, 98, 99, 100]"
commander.js,17761,669,654,15,"[1, 2, 3, 4, 6, 7, 9, 10, 12, 13, 14, 18, 19, 21, 24, 26, 27, 29, 30, 31, 32, 33, 36, 37, 39, 43, 44, 46, 47, 48, 50, 51, 53, 56, 57, 59, 60, 61, 63, 64, 66, 71, 72, 74, 76, 78, 79, 80, 81, 82, 88, 90, 91, 92, 94, 95, 97, 99, 105, 106, 107, 108, 109, 110, 113, 114, 115, 116, 117, 118, 119, 123, 124, 125, 126, 128, 129, 132, 136, 137, 141, 142, 146, 150, 151, 152, 153, 154, 159, 162, 163, 165, 166, 168, 170, 171, 174, 175, 178, 179]"
awesome-docker,17752,98,98,0,"[5, 6, 23, 37, 48, 111, 139, 160, 177, 178, 210, 211, 219, 224, 236, 254, 259, 279, 311, 318, 339, 378, 393, 394, 395, 402, 407, 434, 446, 453, 468, 477, 478, 479, 502, 520, 524, 532, 543, 544, 545, 581, 586, 588, 604, 621, 638, 642, 657, 668, 671, 673, 674, 677, 680, 688, 697, 699, 700, 705, 707, 710, 712, 713, 714, 716, 718, 723, 724, 726, 727, 730, 732, 735, 739, 741, 742, 743, 745, 746, 747, 748, 750, 752, 757, 792, 796, 797, 804, 813, 816, 818, 819, 822, 832, 841, 844, 848]"
Masonry,17713,435,327,108,"[1, 3, 4, 6, 7, 8, 9, 12, 14, 19, 22, 25, 27, 28, 31, 32, 33, 34, 35, 36, 37, 38, 39, 40, 43, 44, 45, 47, 48, 49, 50, 51, 57, 59, 61, 64, 67, 70, 71, 72, 73, 74, 75, 76, 79, 80, 81, 82, 85, 87, 88, 89, 94, 95, 97, 101, 102, 103, 106, 108, 109, 110, 111, 112, 113, 114, 116, 117, 118, 119, 120, 122, 123, 124, 125, 126, 127, 128, 129, 130, 131, 132, 133, 134, 135, 136, 137, 138, 139, 140, 141, 143, 144, 145, 146, 147, 149, 151, 152, 153]"
flv.js,17688,516,260,256,"[2, 3, 6, 7, 8, 9, 10, 11, 13, 14, 16, 19, 20, 22, 23, 24, 25, 26, 27, 29, 31, 32, 33, 34, 35, 36, 37, 38, 39, 40, 41, 42, 43, 44, 45, 46, 47, 48, 51, 52, 53, 56, 57, 58, 59, 60, 62, 63, 64, 65, 66, 67, 68, 69, 70, 71, 72, 73, 74, 75, 76, 77, 78, 79, 80, 81, 82, 83, 84, 85, 86, 87, 88, 89, 90, 91, 92, 93, 94, 95, 96, 97, 98, 99, 101, 102, 103, 104, 105, 106, 107, 108, 109, 110, 111, 113, 114, 115, 116, 117]"
popmotion,17656,543,533,10,"[23, 50, 51, 52, 53, 54, 55, 61, 68, 69, 73, 75, 76, 77, 79, 80, 81, 82, 84, 85, 86, 87, 89, 90, 92, 93, 94, 95, 96, 97, 98, 99, 101, 102, 104, 106, 107, 110, 113, 115, 119, 120, 122, 123, 124, 125, 126, 127, 128, 129, 131, 133, 136, 137, 138, 139, 140, 142, 143, 144, 145, 146, 147, 148, 150, 152, 154, 155, 156, 157, 159, 161, 162, 164, 165, 166, 167, 168, 169, 170, 172, 173, 174, 175, 177, 178, 179, 180, 181, 184, 185, 187, 188, 190, 191, 192, 193, 194, 197, 198]"
etcher,17653,1400,1176,224,"[12, 17, 18, 20, 21, 22, 23, 24, 25, 26, 28, 29, 30, 31, 33, 34, 35, 39, 40, 41, 44, 45, 50, 52, 54, 55, 62, 68, 74, 84, 86, 87, 88, 89, 90, 96, 113, 121, 122, 124, 125, 127, 129, 132, 158, 163, 168, 170, 171, 173, 177, 179, 181, 190, 191, 192, 193, 202, 210, 212, 215, 250, 251, 252, 253, 254, 255, 256, 257, 258, 265, 266, 267, 271, 272, 273, 276, 277, 278, 279, 280, 281, 287, 289, 290, 291, 292, 293, 294, 295, 296, 297, 298, 304, 307, 308, 309, 310, 312, 314]"
os-tutorial,17643,79,50,29,"[1, 2, 3, 4, 5, 9, 11, 12, 13, 14, 16, 17, 18, 19, 20, 22, 23, 24, 26, 28, 31, 32, 34, 37, 38, 39, 41, 42, 43, 44, 45, 46, 47, 51, 52, 53, 56, 59, 63, 71, 72, 79, 84, 85, 87, 88, 89, 90, 102, 103, 105, 109, 112, 113, 114, 115, 118, 121, 123, 124, 125, 126, 127, 129, 130, 131, 132, 133, 135, 136, 138, 141, 142, 143, 144, 145, 146, 147, 148]"
ipfs,17635,202,202,0,"[1, 3, 7, 10, 15, 16, 18, 20, 21, 26, 32, 35, 36, 40, 49, 51, 52, 56, 59, 61, 62, 64, 67, 71, 74, 75, 76, 79, 81, 83, 85, 86, 87, 88, 92, 94, 95, 96, 99, 101, 105, 106, 107, 112, 113, 114, 115, 119, 122, 127, 129, 133, 135, 136, 139, 140, 144, 147, 148, 149, 151, 153, 154, 156, 158, 160, 162, 163, 165, 171, 172, 173, 177, 178, 181, 182, 184, 185, 186, 187, 190, 191, 192, 194, 195, 196, 197, 198, 200, 202, 203, 204, 206, 209, 210, 212, 213, 217, 219, 221]"
nsq,17630,517,471,46,"[34, 62, 66, 67, 68, 85, 97, 104, 109, 112, 113, 126, 136, 137, 146, 155, 156, 159, 165, 166, 181, 189, 212, 219, 222, 224, 226, 246, 253, 261, 265, 268, 276, 283, 284, 287, 289, 299, 302, 304, 307, 308, 313, 316, 317, 320, 322, 328, 331, 333, 335, 341, 342, 343, 344, 346, 347, 348, 349, 350, 351, 355, 362, 363, 364, 369, 371, 372, 373, 374, 375, 376, 380, 381, 382, 387, 388, 393, 394, 395, 400, 401, 403, 405, 409, 410, 414, 418, 420, 430, 432, 433, 436, 439, 443, 450, 452, 453, 457, 462]"
material-dialogs,17629,1177,1140,37,"[2, 3, 6, 8, 9, 10, 11, 12, 14, 15, 17, 18, 19, 20, 25, 26, 28, 29, 31, 32, 33, 34, 35, 36, 37, 38, 39, 40, 43, 44, 45, 46, 49, 50, 56, 58, 60, 61, 62, 63, 64, 65, 66, 67, 68, 69, 71, 74, 77, 78, 79, 80, 81, 82, 83, 85, 86, 87, 88, 89, 90, 93, 94, 96, 97, 98, 99, 100, 104, 105, 107, 109, 110, 111, 113, 114, 115, 116, 117, 119, 120, 122, 123, 125, 126, 129, 130, 132, 133, 134, 135, 137, 138, 139, 141, 142, 143, 144, 145, 147]"
xi-editor,17622,504,382,122,"[1, 2, 4, 5, 6, 7, 10, 14, 15, 19, 21, 22, 23, 25, 26, 27, 28, 29, 32, 35, 38, 40, 44, 45, 47, 48, 51, 52, 57, 58, 60, 63, 65, 68, 69, 72, 75, 78, 79, 80, 81, 84, 85, 86, 88, 89, 90, 91, 92, 93, 95, 96, 99, 107, 114, 115, 116, 117, 119, 121, 123, 124, 125, 128, 130, 131, 134, 138, 140, 141, 142, 143, 144, 147, 150, 153, 158, 159, 160, 161, 163, 165, 166, 168, 169, 170, 173, 174, 175, 177, 181, 182, 184, 185, 186, 187, 188, 190, 191, 193]"
selenium,17590,6432,6041,391,"[330, 332, 333, 334, 335, 337, 338, 339, 340, 341, 342, 344, 345, 347, 349, 350, 351, 353, 354, 355, 356, 358, 359, 360, 361, 362, 363, 364, 365, 367, 368, 369, 370, 373, 374, 375, 378, 379, 380, 381, 382, 383, 384, 385, 386, 388, 389, 390, 391, 392, 393, 395, 396, 397, 398, 399, 400, 401, 402, 404, 407, 408, 409, 410, 411, 412, 417, 420, 422, 423, 424, 425, 426, 427, 428, 430, 431, 432, 433, 434, 435, 437, 439, 441, 442, 443, 444, 446, 447, 448, 451, 452, 453, 454, 455, 456, 458, 459, 460, 461]"
swagger-ui,17585,4033,3546,487,"[2, 3, 4, 5, 6, 10, 11, 14, 15, 18, 19, 24, 25, 26, 27, 28, 29, 30, 31, 32, 33, 34, 35, 36, 37, 38, 39, 40, 43, 44, 45, 46, 47, 48, 51, 53, 54, 57, 58, 59, 60, 61, 62, 63, 64, 66, 67, 68, 70, 71, 72, 75, 76, 78, 85, 86, 87, 92, 98, 99, 100, 101, 105, 106, 107, 108, 109, 110, 112, 113, 114, 115, 116, 117, 118, 119, 120, 121, 122, 123, 124, 125, 126, 127, 128, 129, 130, 131, 132, 134, 135, 136, 137, 138, 139, 140, 142, 143, 144, 145]"
tmux,17583,1855,1851,4,"[5, 7, 8, 9, 10, 11, 12, 13, 14, 16, 17, 18, 21, 22, 24, 25, 26, 27, 28, 29, 31, 32, 33, 34, 36, 37, 39, 40, 41, 42, 43, 44, 46, 47, 48, 49, 50, 51, 52, 54, 55, 58, 60, 61, 62, 63, 64, 65, 66, 67, 68, 69, 70, 71, 72, 73, 74, 75, 76, 78, 79, 80, 81, 82, 83, 85, 86, 87, 88, 89, 90, 91, 92, 93, 94, 96, 97, 98, 99, 100, 101, 102, 103, 104, 105, 106, 107, 108, 109, 110, 111, 113, 114, 115, 116, 117, 118, 119, 120, 126]"
Aerial,17573,713,686,27,"[1, 3, 4, 5, 6, 7, 8, 9, 10, 11, 12, 13, 14, 15, 16, 17, 18, 19, 20, 21, 22, 23, 24, 25, 26, 27, 28, 29, 30, 31, 32, 33, 34, 35, 36, 37, 38, 39, 40, 41, 43, 44, 46, 47, 48, 51, 52, 53, 54, 55, 56, 57, 58, 59, 60, 61, 62, 63, 64, 65, 66, 67, 69, 70, 71, 72, 73, 74, 75, 76, 77, 78, 81, 82, 92, 112, 113, 114, 115, 116, 117, 118, 119, 120, 121, 124, 129, 130, 131, 132, 133, 134, 135, 136, 137, 138, 139, 140, 141, 142]"
weex,17565,1845,1310,535,"[1, 2, 3, 9, 11, 12, 14, 15, 20, 23, 27, 28, 30, 32, 34, 42, 44, 49, 50, 51, 57, 60, 61, 62, 63, 66, 68, 69, 72, 73, 74, 76, 79, 81, 82, 86, 93, 95, 100, 101, 105, 106, 110, 112, 113, 114, 117, 119, 120, 121, 124, 126, 128, 130, 134, 135, 138, 139, 141, 144, 146, 148, 149, 152, 154, 155, 156, 157, 160, 161, 162, 163, 164, 165, 166, 167, 169, 170, 171, 172, 173, 175, 176, 177, 179, 180, 183, 184, 185, 186, 187, 189, 190, 191, 195, 197, 198, 199, 200, 201]"
react-bootstrap,17543,2666,2578,88,"[1, 2, 4, 5, 7, 14, 15, 16, 17, 18, 19, 20, 21, 22, 23, 24, 26, 27, 29, 35, 38, 48, 50, 51, 53, 55, 56, 57, 60, 62, 63, 67, 68, 75, 77, 79, 81, 82, 83, 87, 91, 92, 93, 94, 95, 96, 98, 99, 100, 101, 102, 103, 112, 113, 115, 117, 120, 129, 130, 135, 138, 146, 147, 150, 153, 155, 156, 157, 159, 160, 165, 166, 169, 170, 171, 173, 174, 175, 176, 180, 183, 184, 188, 189, 190, 192, 193, 194, 196, 197, 200, 201, 202, 205, 206, 207, 208, 211, 212, 217]"
neural-style,17506,435,141,294,"[2, 3, 4, 5, 6, 7, 8, 9, 10, 11, 12, 13, 14, 15, 17, 18, 19, 20, 21, 22, 24, 28, 29, 30, 31, 32, 33, 34, 35, 36, 37, 38, 39, 40, 41, 42, 43, 44, 45, 46, 47, 48, 49, 52, 53, 56, 57, 58, 59, 60, 61, 62, 63, 64, 65, 66, 67, 68, 69, 70, 72, 73, 74, 75, 77, 78, 79, 81, 82, 83, 84, 85, 86, 87, 88, 89, 90, 91, 92, 93, 94, 95, 96, 101, 102, 103, 104, 105, 106, 107, 109, 110, 111, 113, 114, 115, 116, 117, 119, 120]"
faas,17503,678,616,62,"[11, 17, 23, 24, 26, 27, 31, 32, 34, 37, 38, 39, 41, 42, 45, 53, 55, 56, 57, 58, 59, 60, 62, 63, 64, 68, 71, 72, 74, 77, 83, 89, 90, 91, 92, 94, 95, 97, 101, 102, 103, 105, 107, 108, 110, 114, 116, 117, 123, 126, 127, 132, 134, 135, 136, 137, 141, 144, 146, 147, 148, 149, 150, 152, 156, 157, 162, 163, 167, 168, 169, 172, 175, 176, 177, 179, 180, 182, 185, 186, 189, 191, 193, 195, 198, 202, 205, 209, 212, 213, 214, 218, 221, 223, 227, 229, 230, 232, 233, 234]"
OpenAPI-Specification,17498,1438,1012,426,"[4, 5, 6, 7, 8, 10, 12, 13, 14, 15, 16, 17, 19, 20, 21, 22, 23, 24, 25, 26, 27, 28, 29, 30, 31, 32, 33, 34, 35, 36, 37, 38, 39, 40, 41, 42, 43, 44, 45, 46, 47, 48, 49, 50, 51, 52, 53, 54, 55, 56, 57, 58, 59, 60, 61, 62, 64, 67, 69, 70, 73, 74, 81, 83, 84, 85, 87, 90, 92, 93, 95, 103, 104, 105, 106, 107, 108, 110, 112, 114, 115, 117, 118, 119, 120, 121, 122, 123, 124, 125, 126, 129, 130, 131, 132, 134, 135, 136, 137, 142]"
zju-icicles,17486,31,24,7,"[1, 2, 3, 6, 15, 21, 24, 30, 43, 50, 55, 58, 59, 60, 74, 81, 82, 85, 86, 87, 88, 89, 112, 116, 123, 125, 128, 129, 134, 135, 136]"
Skeleton,17473,193,122,71,"[3, 4, 7, 8, 9, 10, 13, 14, 15, 19, 20, 21, 23, 24, 26, 27, 29, 30, 31, 33, 36, 37, 39, 40, 41, 42, 43, 44, 45, 46, 48, 56, 58, 59, 60, 61, 63, 64, 68, 69, 72, 73, 74, 75, 76, 77, 81, 84, 85, 86, 87, 88, 90, 92, 97, 98, 102, 110, 112, 116, 118, 120, 122, 123, 126, 131, 132, 134, 136, 138, 139, 140, 141, 142, 143, 144, 145, 148, 149, 151, 152, 153, 157, 159, 160, 161, 163, 165, 167, 168, 169, 173, 178, 180, 181, 183, 186, 196, 197, 198]"
darknet,17467,1910,453,1457,"[1, 72, 73, 75, 76, 77, 78, 79, 80, 81, 82, 83, 85, 87, 88, 89, 92, 94, 95, 98, 99, 101, 102, 103, 104, 105, 106, 107, 109, 110, 113, 114, 115, 116, 117, 118, 119, 120, 121, 122, 123, 124, 125, 126, 127, 128, 129, 130, 133, 134, 135, 136, 138, 139, 140, 141, 142, 143, 144, 146, 147, 148, 149, 150, 151, 152, 153, 155, 156, 157, 158, 159, 160, 161, 163, 164, 165, 166, 167, 169, 170, 171, 172, 173, 174, 175, 176, 177, 178, 179, 180, 181, 182, 183, 184, 185, 186, 187, 188, 189]"
slate,17449,2200,2024,176,"[1, 2, 3, 4, 5, 6, 7, 8, 9, 10, 11, 12, 13, 14, 15, 16, 17, 18, 19, 20, 21, 22, 23, 24, 25, 26, 27, 28, 29, 30, 31, 32, 33, 34, 35, 36, 37, 38, 39, 40, 41, 42, 43, 44, 45, 46, 47, 48, 49, 50, 51, 52, 53, 54, 55, 56, 57, 58, 59, 60, 61, 62, 63, 64, 65, 66, 67, 68, 69, 70, 71, 72, 73, 74, 75, 76, 78, 80, 81, 82, 83, 85, 86, 87, 88, 89, 91, 92, 93, 94, 96, 97, 98, 99, 100, 101, 103, 104, 106, 107]"
jstraining,17444,41,41,0,"[5, 7, 10, 11, 12, 14, 17, 19, 20, 22, 23, 24, 25, 26, 27, 28, 29, 30, 31, 33, 35, 36, 39, 40, 41, 42, 43, 48, 49, 51, 53, 54, 55, 56, 59, 60, 61, 62, 63, 64, 67]"
picasso,17444,1498,1317,181,"[2, 3, 4, 5, 7, 8, 11, 12, 13, 14, 15, 16, 17, 18, 20, 22, 23, 24, 25, 26, 28, 31, 32, 33, 35, 38, 39, 41, 42, 47, 49, 52, 53, 54, 59, 60, 62, 63, 64, 65, 68, 69, 70, 73, 75, 78, 79, 80, 83, 84, 88, 90, 93, 97, 100, 101, 103, 105, 106, 107, 110, 111, 112, 114, 115, 116, 117, 118, 120, 121, 122, 125, 132, 137, 148, 149, 150, 155, 156, 160, 162, 166, 169, 171, 172, 173, 174, 175, 176, 177, 178, 181, 182, 183, 184, 185, 186, 187, 201, 203]"
parse-server,17423,3645,3553,92,"[1, 3, 4, 5, 6, 7, 8, 9, 10, 11, 12, 13, 14, 15, 16, 17, 19, 20, 21, 22, 24, 25, 26, 27, 28, 29, 31, 32, 33, 34, 35, 36, 37, 38, 39, 40, 41, 42, 43, 45, 47, 48, 49, 50, 51, 52, 53, 55, 56, 58, 59, 60, 61, 62, 63, 64, 65, 66, 67, 68, 69, 70, 71, 72, 74, 75, 76, 77, 78, 79, 80, 81, 82, 83, 84, 85, 88, 90, 92, 93, 94, 95, 98, 99, 100, 101, 102, 103, 104, 106, 107, 109, 110, 111, 112, 115, 116, 117, 118, 119]"
acme.sh,17387,1685,1187,498,"[1, 2, 4, 13, 17, 19, 21, 22, 23, 24, 27, 31, 33, 35, 36, 40, 41, 44, 47, 48, 49, 50, 55, 56, 57, 58, 60, 61, 62, 63, 64, 65, 66, 67, 68, 70, 71, 72, 74, 76, 77, 78, 79, 80, 83, 85, 88, 89, 93, 94, 95, 96, 100, 103, 104, 106, 107, 108, 111, 112, 113, 114, 115, 116, 117, 119, 122, 123, 124, 125, 126, 128, 129, 130, 132, 134, 135, 136, 137, 138, 139, 140, 142, 144, 145, 146, 147, 148, 149, 150, 151, 152, 153, 157, 161, 162, 163, 164, 165, 166]"
odoo,17382,12288,11024,1264,"[5, 7, 8, 10, 11, 13, 25, 29, 30, 31, 32, 34, 35, 37, 39, 41, 42, 47, 49, 57, 58, 61, 64, 65, 67, 77, 80, 91, 98, 105, 123, 129, 130, 131, 132, 133, 139, 147, 165, 167, 169, 171, 173, 179, 185, 186, 187, 189, 190, 191, 192, 193, 197, 198, 204, 206, 220, 227, 231, 240, 241, 242, 250, 254, 256, 257, 259, 260, 262, 264, 270, 271, 273, 275, 277, 280, 281, 282, 283, 284, 285, 289, 290, 291, 296, 304, 306, 307, 308, 309, 311, 313, 315, 318, 327, 334, 337, 345, 346, 347]"
monolog,17355,617,565,52,"[12, 14, 15, 18, 19, 25, 34, 36, 37, 38, 48, 51, 53, 55, 56, 57, 64, 65, 66, 68, 69, 71, 72, 78, 82, 83, 85, 86, 87, 89, 91, 95, 102, 103, 104, 108, 110, 111, 116, 118, 120, 128, 131, 133, 138, 143, 146, 150, 152, 153, 154, 157, 160, 165, 170, 172, 178, 180, 182, 183, 187, 188, 192, 194, 196, 197, 199, 200, 201, 204, 206, 207, 212, 217, 218, 219, 224, 225, 229, 234, 237, 245, 249, 255, 256, 259, 265, 268, 272, 276, 277, 280, 281, 285, 286, 289, 296, 298, 299, 302]"
passport,17341,640,323,317,"[1, 3, 4, 5, 6, 8, 9, 10, 11, 12, 13, 14, 15, 16, 17, 18, 19, 20, 21, 22, 23, 26, 27, 28, 29, 30, 31, 32, 34, 35, 36, 37, 38, 39, 40, 41, 42, 43, 44, 46, 47, 49, 50, 51, 52, 53, 54, 55, 56, 57, 59, 60, 61, 62, 63, 64, 65, 67, 68, 69, 71, 72, 73, 74, 75, 76, 77, 78, 79, 80, 81, 82, 83, 84, 86, 87, 88, 89, 90, 93, 94, 95, 96, 97, 98, 100, 101, 102, 103, 105, 108, 109, 111, 112, 113, 114, 115, 117, 118, 119]"
hyperapp,17334,515,501,14,"[2, 4, 5, 6, 7, 8, 9, 10, 11, 12, 13, 14, 15, 16, 22, 25, 30, 33, 34, 35, 38, 39, 41, 43, 47, 49, 50, 51, 53, 55, 56, 59, 61, 62, 63, 65, 66, 67, 68, 69, 70, 72, 73, 75, 76, 78, 81, 82, 83, 85, 86, 87, 88, 90, 91, 92, 93, 94, 95, 98, 99, 100, 101, 102, 103, 104, 105, 106, 107, 108, 109, 110, 111, 112, 114, 116, 117, 120, 121, 123, 125, 126, 128, 129, 132, 136, 138, 143, 144, 145, 146, 147, 148, 149, 152, 153, 154, 155, 156, 157]"
algorithms,17272,113,77,36,"[5, 10, 12, 15, 17, 18, 21, 24, 29, 31, 49, 53, 59, 61, 72, 80, 98, 113, 118, 119, 120, 124, 137, 162, 173, 181, 182, 187, 190, 198, 210, 213, 218, 219, 226, 228, 240, 241, 246, 247, 254, 256, 257, 258, 264, 275, 277, 278, 282, 293, 315, 318, 321, 322, 326, 328, 330, 331, 337, 350, 357, 364, 369, 377, 380, 383, 388, 395, 400, 401, 404, 406, 410, 431, 456, 457, 462, 465, 468, 469, 472, 479, 480, 488, 492, 494, 504, 505, 507, 508, 521, 523, 526, 559, 565, 567, 569, 580, 590, 595]"
aspnetcore,17256,15412,13116,2296,"[6, 7, 8, 15, 16, 17, 18, 20, 21, 22, 24, 25, 26, 27, 28, 29, 30, 31, 33, 34, 35, 37, 38, 39, 40, 41, 42, 45, 47, 49, 50, 51, 52, 54, 56, 58, 59, 60, 61, 62, 65, 66, 67, 69, 70, 71, 72, 73, 78, 79, 81, 83, 84, 85, 88, 89, 91, 92, 93, 94, 95, 96, 98, 101, 103, 104, 105, 106, 107, 109, 111, 113, 114, 116, 117, 118, 121, 123, 125, 126, 128, 129, 130, 131, 132, 133, 134, 135, 137, 138, 139, 142, 143, 144, 145, 146, 152, 153, 154, 155]"
django-rest-framework,17237,3421,3264,157,"[2, 3, 4, 5, 6, 7, 8, 9, 10, 11, 12, 13, 14, 15, 16, 17, 19, 20, 21, 22, 24, 25, 26, 27, 28, 29, 30, 31, 32, 34, 36, 41, 42, 47, 48, 50, 51, 54, 55, 56, 60, 61, 63, 65, 66, 67, 69, 73, 74, 75, 76, 78, 79, 81, 84, 85, 86, 87, 88, 89, 91, 95, 96, 98, 99, 100, 102, 103, 106, 107, 112, 114, 116, 122, 123, 124, 126, 127, 128, 131, 133, 134, 137, 139, 140, 146, 147, 148, 149, 153, 158, 161, 163, 164, 165, 166, 167, 170, 178, 180]"
npm,17206,18672,16505,2167,"[1, 2, 3, 4, 5, 6, 7, 8, 9, 10, 11, 12, 13, 14, 15, 16, 17, 18, 19, 20, 21, 22, 23, 24, 25, 26, 27, 28, 29, 30, 31, 32, 33, 34, 35, 36, 37, 38, 39, 40, 41, 42, 43, 44, 45, 46, 47, 48, 49, 50, 51, 52, 53, 54, 55, 56, 57, 58, 59, 60, 61, 62, 63, 64, 65, 66, 67, 68, 69, 70, 71, 72, 73, 74, 75, 76, 77, 78, 79, 80, 81, 82, 83, 84, 85, 86, 87, 88, 89, 90, 91, 92, 93, 94, 95, 96, 97, 98, 99, 100]"
learnGitBranching,17173,315,281,34,"[2, 3, 4, 5, 6, 7, 8, 9, 10, 11, 14, 15, 18, 19, 20, 22, 24, 26, 28, 29, 30, 31, 35, 36, 37, 39, 40, 41, 42, 43, 44, 45, 50, 51, 52, 53, 54, 56, 57, 58, 59, 60, 61, 62, 63, 64, 68, 69, 70, 71, 72, 73, 76, 81, 82, 84, 85, 86, 87, 89, 91, 92, 93, 94, 98, 99, 100, 101, 102, 103, 104, 105, 106, 107, 108, 109, 110, 111, 112, 114, 115, 117, 118, 119, 120, 122, 123, 124, 125, 126, 127, 128, 129, 130, 131, 132, 133, 134, 138, 139]"
Python,17164,117,53,64,"[1, 2, 8, 11, 13, 14, 27, 28, 32, 33, 37, 44, 47, 49, 54, 69, 121, 127, 128, 150, 152, 155, 158, 163, 171, 179, 181, 182, 193, 198, 200, 202, 209, 211, 212, 219, 223, 224, 227, 240, 260, 265, 268, 274, 288, 294, 296, 302, 303, 307, 312, 313, 315, 316, 319, 325, 326, 328, 329, 334, 343, 348, 349, 352, 356, 357, 358, 360, 400, 431, 434, 441, 442, 455, 459, 462, 474, 476, 479, 483, 494, 498, 499, 503, 509, 513, 515, 517, 519, 521, 522, 528, 531, 548, 552, 572, 621, 623, 651, 662]"
echo,17153,993,964,29,"[1, 2, 3, 5, 9, 10, 12, 13, 14, 16, 18, 20, 21, 22, 23, 24, 25, 26, 27, 29, 30, 31, 32, 33, 38, 42, 43, 44, 46, 48, 49, 50, 51, 52, 53, 55, 57, 58, 59, 63, 65, 67, 68, 71, 72, 74, 75, 78, 79, 80, 81, 82, 83, 84, 87, 88, 89, 90, 93, 94, 95, 96, 97, 98, 99, 100, 102, 103, 104, 107, 110, 111, 112, 113, 114, 118, 119, 120, 122, 124, 131, 132, 135, 136, 137, 139, 140, 141, 144, 145, 146, 147, 148, 150, 151, 152, 154, 155, 156, 158]"
architecture.of.internet-product,17146,10,3,7,"[1, 2, 3, 4, 5, 6, 8, 9, 11, 12]"
Dress,17143,301,224,77,"[2, 3, 5, 7, 8, 10, 12, 24, 25, 27, 29, 30, 31, 36, 41, 44, 52, 56, 61, 66, 68, 76, 82, 85, 86, 87, 88, 89, 91, 92, 95, 96, 97, 98, 99, 100, 101, 103, 104, 106, 109, 110, 111, 113, 114, 115, 118, 122, 123, 125, 127, 128, 129, 130, 134, 138, 139, 142, 144, 150, 156, 159, 162, 167, 168, 169, 170, 172, 177, 178, 179, 183, 186, 187, 188, 189, 190, 191, 194, 195, 197, 200, 204, 216, 218, 219, 221, 222, 224, 226, 227, 229, 230, 233, 234, 241, 243, 244, 245, 249]"
vue-devtools,17133,877,663,214,"[1, 2, 3, 4, 5, 6, 13, 14, 16, 18, 21, 35, 41, 43, 51, 53, 57, 58, 59, 60, 61, 62, 63, 64, 65, 66, 68, 69, 70, 72, 74, 75, 76, 77, 78, 79, 80, 81, 82, 83, 84, 85, 86, 87, 88, 89, 90, 91, 92, 96, 97, 98, 99, 100, 101, 103, 105, 106, 107, 110, 112, 113, 115, 116, 117, 118, 119, 120, 121, 122, 123, 124, 125, 127, 128, 129, 130, 131, 132, 133, 134, 135, 136, 137, 138, 139, 140, 141, 142, 144, 145, 146, 147, 149, 150, 151, 152, 153, 154, 155]"
awesome-vscode,17107,32,19,13,"[1, 4, 7, 9, 10, 12, 30, 34, 36, 41, 76, 77, 81, 91, 104, 117, 123, 130, 166, 168, 169, 189, 191, 199, 208, 222, 232, 257, 264, 277, 294, 308]"
sqlmap,17077,3868,3821,47,"[1, 2, 3, 4, 5, 6, 7, 8, 9, 10, 11, 12, 13, 14, 15, 16, 17, 18, 19, 20, 21, 22, 23, 24, 25, 26, 27, 28, 29, 30, 31, 32, 33, 34, 35, 36, 37, 38, 40, 42, 43, 44, 45, 46, 48, 49, 50, 51, 52, 54, 55, 56, 57, 58, 59, 60, 61, 62, 64, 65, 66, 67, 68, 69, 70, 71, 72, 75, 76, 77, 78, 79, 80, 81, 82, 83, 84, 85, 87, 88, 89, 90, 91, 92, 93, 94, 95, 96, 97, 100, 101, 103, 104, 105, 106, 108, 109, 110, 111, 112]"
d2l-zh,17065,0,0,0,[]
Real-Time-Voice-Cloning,17059,291,148,143,"[1, 2, 3, 4, 10, 11, 12, 13, 15, 16, 17, 19, 20, 21, 22, 23, 24, 25, 26, 27, 28, 29, 30, 31, 32, 33, 34, 36, 38, 39, 40, 41, 42, 43, 44, 45, 46, 47, 48, 49, 51, 52, 53, 54, 55, 56, 57, 58, 59, 60, 61, 62, 63, 64, 65, 66, 67, 68, 70, 71, 72, 73, 74, 75, 76, 78, 79, 80, 81, 82, 83, 84, 85, 86, 87, 88, 89, 90, 91, 92, 93, 94, 95, 96, 97, 98, 99, 100, 101, 102, 106, 107, 108, 109, 110, 111, 112, 113, 114, 115]"
curl,17054,2226,2192,34,"[142, 146, 147, 148, 149, 150, 151, 152, 153, 160, 161, 163, 166, 167, 169, 183, 184, 186, 187, 188, 192, 195, 198, 207, 210, 211, 216, 217, 218, 219, 220, 221, 222, 223, 224, 225, 226, 229, 231, 232, 233, 234, 235, 236, 237, 238, 240, 244, 251, 253, 254, 255, 256, 259, 264, 265, 266, 267, 269, 270, 273, 275, 277, 278, 281, 282, 283, 286, 287, 288, 290, 292, 293, 296, 297, 298, 299, 300, 313, 315, 317, 318, 320, 322, 323, 324, 325, 326, 328, 329, 330, 332, 333, 334, 336, 342, 343, 344, 345, 346]"
windows95,17047,140,86,54,"[1, 2, 3, 4, 5, 6, 7, 8, 9, 10, 11, 12, 13, 14, 15, 18, 19, 20, 21, 22, 23, 24, 25, 26, 27, 28, 29, 30, 31, 32, 33, 34, 35, 36, 37, 38, 39, 40, 41, 42, 43, 44, 45, 46, 47, 48, 49, 50, 51, 53, 54, 55, 56, 57, 58, 59, 60, 61, 62, 63, 64, 65, 67, 68, 69, 70, 71, 72, 73, 74, 75, 76, 77, 78, 79, 80, 81, 82, 83, 84, 85, 86, 88, 90, 91, 92, 93, 94, 95, 97, 98, 99, 100, 101, 102, 104, 105, 107, 108, 110]"
localForage,17040,607,454,153,"[1, 2, 3, 4, 6, 7, 9, 10, 12, 14, 15, 17, 18, 21, 23, 27, 28, 29, 30, 31, 32, 34, 35, 39, 40, 41, 43, 44, 45, 46, 47, 50, 52, 55, 57, 58, 60, 62, 63, 64, 65, 66, 68, 69, 70, 72, 74, 75, 78, 81, 82, 83, 85, 86, 91, 92, 93, 96, 102, 104, 105, 106, 108, 110, 113, 114, 115, 116, 117, 121, 126, 128, 131, 132, 134, 135, 136, 137, 139, 141, 143, 144, 145, 148, 149, 150, 151, 154, 155, 157, 158, 161, 162, 163, 164, 165, 166, 168, 169, 170]"
wtfjs,17020,65,29,36,"[6, 10, 11, 12, 15, 19, 23, 24, 25, 27, 28, 29, 30, 33, 35, 37, 42, 43, 46, 47, 49, 51, 52, 55, 61, 63, 70, 76, 77, 78, 79, 84, 85, 87, 88, 89, 90, 91, 92, 93, 99, 101, 103, 106, 107, 109, 112, 113, 115, 116, 118, 120, 121, 123, 124, 125, 131, 132, 134, 135, 137, 138, 139, 140, 147]"
helm,17014,4497,3749,748,"[1, 3, 5, 6, 13, 14, 15, 16, 18, 19, 20, 21, 22, 23, 25, 35, 36, 37, 38, 39, 41, 43, 45, 46, 47, 49, 50, 52, 53, 54, 55, 56, 57, 58, 59, 60, 61, 62, 63, 64, 65, 66, 67, 68, 70, 72, 75, 79, 80, 82, 83, 85, 87, 89, 92, 98, 99, 104, 105, 107, 109, 110, 111, 112, 116, 118, 122, 123, 124, 125, 129, 132, 137, 144, 145, 146, 149, 151, 152, 157, 158, 159, 161, 171, 174, 175, 176, 177, 179, 180, 181, 183, 185, 186, 188, 206, 209, 211, 212, 213]"
prisma1,17003,3390,2874,516,"[1, 2, 3, 4, 5, 6, 7, 8, 9, 10, 11, 12, 13, 14, 15, 16, 17, 18, 19, 20, 21, 22, 23, 24, 25, 26, 27, 28, 29, 30, 31, 32, 33, 34, 35, 36, 37, 38, 39, 40, 41, 42, 43, 44, 45, 46, 47, 48, 49, 50, 51, 52, 53, 54, 55, 56, 57, 58, 59, 60, 61, 62, 63, 64, 65, 66, 67, 68, 69, 70, 71, 72, 73, 74, 75, 76, 77, 78, 79, 80, 81, 82, 83, 84, 85, 86, 87, 88, 89, 90, 91, 92, 93, 94, 95, 96, 97, 98, 99, 100]"
hosts,16989,891,888,3,"[1, 2, 3, 5, 6, 7, 8, 11, 12, 17, 21, 22, 23, 24, 25, 26, 29, 32, 36, 38, 40, 41, 42, 44, 46, 47, 51, 53, 54, 55, 57, 59, 60, 61, 63, 65, 66, 67, 68, 69, 70, 71, 72, 73, 74, 75, 79, 80, 81, 82, 86, 87, 90, 92, 93, 94, 95, 96, 97, 98, 100, 101, 102, 103, 104, 105, 107, 110, 114, 115, 116, 117, 118, 121, 124, 125, 127, 128, 129, 130, 131, 133, 135, 136, 137, 138, 139, 140, 141, 142, 143, 144, 145, 147, 148, 149, 150, 151, 152, 153]"
vux,16953,3217,2462,755,"[2, 3, 4, 5, 6, 7, 8, 9, 10, 11, 12, 14, 15, 16, 17, 18, 19, 21, 22, 23, 24, 26, 27, 28, 29, 30, 31, 32, 34, 39, 40, 41, 42, 43, 45, 46, 48, 49, 50, 51, 52, 53, 54, 55, 56, 57, 58, 59, 60, 61, 62, 63, 64, 65, 66, 67, 69, 70, 71, 73, 75, 76, 79, 80, 81, 82, 83, 88, 89, 90, 93, 94, 96, 97, 98, 102, 104, 105, 107, 108, 109, 110, 111, 112, 113, 117, 118, 119, 120, 123, 124, 125, 126, 127, 128, 131, 134, 135, 136, 137]"
homebrew-cask,16946,5373,5334,39,"[6, 7, 9, 12, 14, 15, 16, 17, 18, 19, 21, 27, 33, 34, 36, 38, 39, 41, 44, 47, 48, 50, 52, 64, 69, 70, 71, 72, 81, 82, 89, 99, 103, 104, 105, 108, 109, 113, 118, 122, 123, 125, 126, 131, 136, 137, 139, 142, 143, 144, 159, 164, 166, 167, 178, 179, 181, 182, 194, 195, 196, 198, 199, 200, 204, 209, 216, 218, 219, 220, 221, 222, 230, 231, 234, 236, 240, 244, 250, 252, 257, 260, 279, 280, 281, 299, 302, 304, 306, 309, 310, 311, 313, 316, 327, 328, 329, 332, 343, 348]"
the-super-tiny-compiler,16927,0,0,0,[]
skill-map,16913,79,13,66,"[6, 9, 10, 11, 12, 13, 14, 15, 17, 18, 19, 20, 21, 22, 24, 25, 26, 28, 29, 30, 35, 36, 37, 39, 40, 41, 43, 44, 46, 48, 51, 52, 53, 55, 69, 71, 72, 76, 77, 78, 79, 80, 81, 83, 84, 85, 86, 87, 88, 90, 92, 93, 94, 95, 96, 97, 98, 103, 104, 105, 107, 108, 109, 110, 114, 115, 116, 117, 118, 121, 122, 124, 130, 131, 132, 133, 134, 135, 138]"
Boostnote,16906,2246,1813,433,"[2, 3, 4, 5, 6, 7, 8, 9, 12, 13, 14, 15, 16, 17, 18, 19, 21, 22, 23, 24, 25, 27, 29, 31, 32, 33, 34, 35, 36, 38, 39, 40, 41, 42, 44, 45, 46, 47, 48, 49, 50, 51, 52, 53, 54, 55, 56, 57, 58, 59, 60, 62, 63, 64, 65, 66, 67, 68, 69, 70, 72, 73, 74, 75, 76, 78, 79, 80, 81, 82, 83, 84, 85, 86, 87, 88, 89, 90, 91, 92, 93, 94, 95, 101, 103, 104, 105, 106, 107, 108, 111, 113, 114, 115, 116, 117, 118, 119, 120, 121]"
architecture-components-samples,16879,554,453,101,"[1, 2, 3, 4, 5, 9, 10, 12, 13, 14, 15, 16, 18, 19, 20, 22, 23, 24, 25, 26, 27, 29, 30, 31, 32, 33, 34, 35, 36, 37, 38, 39, 40, 41, 42, 43, 44, 46, 47, 48, 49, 50, 51, 52, 53, 54, 55, 56, 57, 58, 59, 60, 61, 62, 63, 64, 65, 66, 67, 69, 71, 74, 75, 76, 80, 81, 83, 84, 85, 86, 87, 88, 90, 91, 92, 94, 96, 97, 98, 99, 100, 101, 102, 104, 105, 106, 107, 108, 109, 111, 112, 113, 114, 115, 116, 117, 120, 122, 124, 127]"
SpinKit,16876,55,52,3,"[2, 5, 6, 9, 13, 17, 20, 21, 28, 30, 31, 34, 37, 42, 46, 47, 48, 51, 58, 59, 60, 63, 65, 69, 71, 72, 73, 78, 81, 83, 93, 96, 97, 102, 109, 110, 116, 117, 118, 120, 122, 127, 128, 130, 131, 135, 136, 137, 139, 141, 147, 148, 150, 151, 152]"
jq,16872,1649,1161,488,"[1, 2, 3, 4, 5, 7, 9, 10, 11, 12, 13, 16, 18, 19, 21, 23, 24, 26, 27, 28, 29, 30, 31, 32, 33, 35, 37, 38, 40, 41, 42, 43, 44, 45, 46, 47, 48, 49, 51, 52, 53, 54, 55, 56, 57, 58, 60, 61, 62, 63, 64, 65, 66, 67, 68, 69, 70, 71, 72, 73, 74, 75, 76, 78, 79, 81, 82, 83, 84, 86, 88, 89, 90, 91, 92, 94, 95, 96, 97, 98, 99, 100, 101, 102, 103, 104, 105, 106, 107, 108, 111, 112, 113, 116, 117, 120, 121, 122, 123, 124]"
libgdx,16868,3124,2847,277,"[592, 593, 594, 595, 596, 597, 598, 599, 600, 601, 602, 603, 604, 605, 606, 607, 608, 609, 610, 611, 612, 613, 614, 615, 616, 617, 618, 619, 620, 621, 622, 623, 624, 625, 626, 627, 628, 629, 630, 631, 632, 633, 634, 635, 636, 637, 638, 639, 640, 641, 642, 643, 644, 645, 646, 647, 648, 649, 650, 651, 652, 653, 654, 655, 656, 657, 658, 659, 660, 661, 662, 663, 664, 665, 666, 667, 668, 669, 670, 671, 672, 673, 674, 675, 676, 677, 678, 679, 680, 681, 682, 683, 684, 685, 686, 687, 688, 689, 690, 691]"
plyr,16850,1406,1003,403,"[1, 2, 3, 4, 5, 6, 8, 9, 10, 34, 35, 36, 37, 38, 39, 40, 42, 43, 44, 45, 46, 47, 48, 49, 50, 51, 52, 53, 54, 58, 59, 60, 61, 63, 64, 65, 66, 67, 68, 69, 71, 72, 73, 74, 77, 78, 79, 80, 81, 82, 83, 84, 85, 86, 87, 88, 89, 90, 91, 92, 93, 94, 95, 96, 97, 98, 100, 101, 103, 105, 109, 110, 112, 113, 114, 115, 116, 117, 118, 119, 120, 121, 124, 125, 127, 128, 129, 130, 131, 132, 133, 135, 136, 137, 143, 144, 145, 146, 148, 149]"
react-spring,16848,708,611,97,"[1, 2, 3, 5, 7, 8, 9, 10, 11, 12, 16, 18, 19, 20, 21, 22, 23, 24, 25, 26, 27, 28, 29, 30, 32, 43, 44, 51, 52, 54, 55, 61, 62, 65, 66, 67, 68, 70, 71, 72, 73, 74, 75, 77, 78, 79, 80, 81, 82, 83, 85, 86, 87, 89, 90, 91, 92, 93, 94, 97, 98, 99, 100, 101, 102, 104, 105, 106, 108, 109, 110, 111, 112, 113, 115, 117, 118, 119, 121, 124, 125, 126, 128, 129, 130, 131, 132, 133, 134, 135, 136, 137, 138, 139, 140, 143, 145, 147, 148, 149]"
Wox,16840,2552,1634,918,"[1, 2, 3, 4, 5, 6, 7, 8, 9, 10, 11, 12, 13, 15, 16, 17, 18, 19, 20, 21, 23, 24, 25, 26, 30, 31, 32, 33, 34, 35, 36, 37, 38, 39, 41, 42, 44, 45, 46, 47, 48, 49, 52, 53, 54, 55, 56, 57, 64, 65, 66, 68, 69, 70, 71, 72, 76, 77, 78, 79, 80, 81, 82, 83, 86, 87, 88, 91, 92, 93, 94, 95, 97, 101, 102, 107, 108, 109, 111, 112, 113, 114, 115, 116, 117, 118, 120, 121, 124, 126, 128, 129, 130, 135, 136, 137, 138, 141, 142, 143]"
openpose,16838,1335,1306,29,"[1, 2, 3, 4, 5, 6, 7, 8, 10, 11, 13, 14, 15, 17, 18, 19, 21, 22, 23, 24, 25, 27, 29, 30, 31, 32, 33, 34, 35, 36, 37, 38, 39, 40, 41, 42, 43, 44, 45, 46, 47, 48, 49, 50, 51, 52, 53, 54, 55, 56, 57, 58, 59, 60, 61, 62, 63, 64, 65, 67, 68, 69, 71, 72, 73, 75, 76, 77, 78, 79, 80, 81, 82, 83, 84, 85, 86, 89, 90, 91, 92, 93, 94, 95, 96, 97, 98, 99, 100, 101, 102, 103, 105, 106, 107, 108, 109, 110, 111, 112]"
engineering-blogs,16838,76,75,1,"[33, 35, 53, 61, 66, 81, 108, 138, 170, 176, 200, 228, 241, 242, 244, 251, 265, 277, 286, 295, 300, 309, 328, 340, 387, 396, 409, 439, 448, 465, 503, 518, 521, 527, 529, 538, 555, 556, 599, 612, 619, 631, 643, 694, 749, 750, 753, 765, 774, 776, 807, 814, 828, 838, 843, 844, 845, 846, 857, 880, 915, 920, 922, 923, 924, 936, 944, 950, 952, 953, 970, 972, 976, 983, 996, 999]"
elixir,16836,4055,4038,17,"[1, 2, 4, 14, 15, 17, 20, 21, 23, 26, 28, 29, 34, 35, 46, 47, 48, 56, 57, 58, 59, 60, 61, 62, 63, 64, 65, 67, 68, 69, 70, 71, 72, 73, 74, 75, 76, 77, 78, 79, 80, 81, 82, 83, 84, 85, 86, 87, 88, 89, 90, 91, 92, 93, 94, 95, 96, 97, 98, 99, 100, 101, 102, 103, 104, 105, 106, 107, 108, 109, 110, 111, 112, 113, 114, 115, 121, 122, 123, 124, 125, 128, 135, 136, 142, 143, 144, 146, 147, 148, 174, 178, 181, 182, 185, 186, 187, 188, 190, 191]"
kit,16822,449,397,52,"[1, 2, 3, 9, 11, 24, 30, 33, 34, 35, 36, 37, 40, 42, 49, 52, 54, 55, 56, 59, 63, 68, 69, 70, 72, 73, 78, 81, 83, 84, 86, 87, 88, 89, 91, 97, 103, 107, 121, 122, 123, 130, 131, 132, 133, 144, 147, 148, 154, 158, 159, 162, 164, 166, 167, 169, 170, 179, 181, 184, 185, 186, 187, 188, 193, 194, 197, 199, 201, 202, 209, 213, 215, 217, 222, 224, 229, 230, 231, 233, 237, 239, 246, 249, 250, 251, 255, 256, 257, 258, 260, 261, 262, 263, 266, 269, 274, 279, 281, 283]"
v,16812,2178,1638,540,"[1, 2, 3, 5, 6, 7, 8, 9, 12, 14, 15, 17, 18, 19, 20, 21, 22, 23, 26, 28, 29, 30, 31, 33, 34, 35, 36, 37, 39, 40, 41, 42, 43, 44, 45, 46, 47, 48, 49, 50, 51, 52, 53, 54, 56, 57, 58, 59, 60, 61, 62, 63, 64, 65, 66, 67, 68, 69, 70, 71, 72, 73, 74, 75, 76, 77, 78, 79, 80, 81, 82, 83, 84, 85, 86, 87, 88, 89, 90, 91, 92, 93, 94, 95, 96, 97, 98, 99, 100, 101, 102, 103, 104, 105, 106, 107, 108, 109, 110, 111]"
my-mac-os,16803,70,68,2,"[1, 5, 6, 7, 8, 9, 10, 11, 12, 13, 14, 15, 16, 17, 18, 21, 22, 25, 27, 29, 32, 35, 36, 37, 38, 39, 41, 42, 44, 45, 46, 47, 50, 52, 53, 54, 55, 56, 57, 58, 59, 60, 61, 62, 63, 64, 65, 66, 67, 68, 70, 71, 76, 77, 78, 79, 84, 87, 91, 92, 94, 95, 96, 98, 99, 100, 102, 103, 104, 105]"
python-fire,16797,164,112,52,"[3, 4, 6, 7, 10, 11, 12, 13, 14, 15, 16, 17, 19, 22, 24, 25, 26, 29, 32, 33, 34, 37, 41, 42, 43, 46, 47, 51, 53, 56, 57, 61, 62, 63, 64, 66, 68, 69, 70, 72, 73, 74, 76, 77, 79, 80, 81, 83, 84, 86, 89, 90, 93, 94, 95, 97, 98, 101, 102, 103, 105, 106, 107, 108, 109, 112, 113, 114, 115, 116, 117, 118, 120, 121, 123, 124, 125, 126, 129, 132, 133, 134, 136, 137, 138, 140, 142, 145, 146, 148, 149, 150, 151, 153, 156, 157, 158, 159, 162, 163]"
ruby,16778,0,0,0,[]
CNTK,16774,3241,2504,737,"[1, 2, 5, 6, 7, 8, 9, 10, 11, 12, 13, 15, 17, 18, 19, 21, 22, 24, 25, 26, 29, 30, 31, 32, 33, 34, 35, 36, 37, 40, 42, 43, 44, 47, 48, 49, 52, 53, 54, 55, 57, 59, 61, 62, 64, 65, 67, 69, 70, 71, 73, 74, 75, 76, 77, 78, 79, 80, 81, 82, 83, 84, 85, 89, 91, 92, 94, 95, 97, 98, 99, 101, 102, 103, 104, 105, 106, 107, 109, 110, 111, 112, 113, 114, 115, 116, 117, 118, 119, 120, 121, 122, 123, 124, 125, 126, 127, 128, 129, 131]"
cobra,16755,564,396,168,"[1, 2, 3, 4, 10, 11, 15, 16, 17, 18, 20, 22, 23, 27, 28, 29, 30, 31, 33, 34, 35, 37, 40, 42, 43, 44, 45, 46, 47, 52, 57, 59, 62, 63, 67, 73, 78, 80, 81, 99, 107, 111, 113, 114, 123, 124, 125, 129, 131, 140, 142, 156, 157, 161, 162, 165, 166, 171, 175, 176, 183, 184, 188, 190, 191, 193, 195, 201, 202, 204, 206, 209, 212, 216, 219, 221, 225, 226, 227, 229, 231, 232, 233, 234, 235, 236, 237, 238, 239, 240, 243, 245, 247, 248, 249, 250, 251, 252, 253, 259]"
docker_practice,16745,175,171,4,"[4, 5, 6, 11, 12, 13, 20, 21, 23, 28, 31, 43, 52, 53, 55, 63, 64, 65, 68, 78, 82, 101, 105, 111, 113, 130, 131, 134, 136, 139, 142, 143, 153, 156, 159, 160, 164, 166, 168, 172, 173, 174, 176, 178, 180, 181, 185, 186, 189, 190, 191, 192, 193, 196, 200, 201, 203, 206, 208, 209, 213, 214, 215, 216, 218, 220, 222, 223, 226, 227, 229, 230, 231, 233, 235, 238, 240, 242, 245, 248, 250, 251, 252, 254, 260, 261, 262, 263, 265, 266, 270, 275, 276, 278, 279, 282, 283, 285, 287, 288]"
osquery,16737,2447,1829,618,"[2, 3, 4, 5, 6, 7, 8, 9, 10, 11, 12, 13, 14, 15, 16, 17, 18, 19, 20, 21, 22, 23, 24, 25, 26, 27, 28, 29, 30, 31, 32, 33, 45, 53, 54, 59, 62, 63, 65, 66, 67, 68, 69, 70, 71, 72, 73, 74, 75, 76, 77, 78, 79, 80, 81, 84, 85, 89, 90, 95, 96, 97, 99, 101, 103, 104, 105, 106, 108, 110, 111, 112, 113, 115, 116, 118, 119, 123, 124, 126, 127, 128, 129, 130, 131, 133, 136, 137, 138, 139, 141, 142, 143, 146, 149, 150, 151, 154, 156, 159]"
fanqiang,16726,475,295,180,"[1, 2, 3, 4, 5, 6, 7, 8, 9, 10, 11, 12, 13, 14, 15, 16, 17, 18, 19, 20, 21, 22, 23, 24, 25, 26, 27, 28, 29, 30, 31, 32, 33, 34, 35, 36, 37, 38, 39, 40, 41, 42, 43, 44, 45, 46, 47, 48, 49, 50, 51, 52, 53, 54, 55, 56, 57, 58, 59, 60, 61, 62, 63, 64, 65, 66, 67, 68, 69, 70, 71, 72, 73, 74, 75, 76, 77, 78, 79, 80, 81, 82, 83, 85, 86, 87, 88, 89, 90, 91, 92, 93, 94, 95, 96, 97, 98, 99, 100, 101]"
Android-Universal-Image-Loader,16709,1205,770,435,"[1, 2, 3, 4, 5, 6, 7, 8, 9, 10, 11, 12, 13, 14, 15, 16, 17, 18, 19, 21, 22, 23, 24, 25, 26, 27, 28, 29, 30, 31, 32, 33, 34, 35, 36, 37, 38, 39, 40, 41, 42, 44, 45, 46, 47, 48, 49, 50, 51, 53, 54, 55, 56, 57, 58, 59, 60, 61, 63, 64, 65, 66, 67, 68, 69, 70, 71, 72, 73, 74, 75, 76, 77, 78, 79, 80, 81, 82, 83, 86, 87, 88, 89, 90, 92, 93, 94, 95, 96, 97, 98, 99, 100, 101, 102, 103, 104, 105, 106, 107]"
flux,16693,228,216,12,"[2, 8, 12, 14, 15, 16, 20, 21, 22, 25, 27, 28, 30, 31, 32, 37, 41, 42, 45, 47, 50, 51, 53, 55, 57, 58, 60, 61, 62, 63, 64, 67, 68, 71, 73, 75, 76, 77, 78, 80, 82, 86, 89, 92, 94, 95, 96, 97, 99, 100, 101, 102, 103, 104, 105, 106, 107, 119, 121, 122, 123, 126, 127, 129, 131, 132, 133, 134, 135, 138, 141, 144, 148, 156, 157, 158, 159, 161, 162, 165, 166, 168, 173, 175, 176, 180, 183, 184, 185, 187, 193, 196, 201, 203, 205, 208, 209, 210, 211, 212]"
PhotoView,16683,615,468,147,"[1, 2, 3, 4, 7, 8, 9, 10, 11, 12, 13, 14, 15, 16, 17, 18, 20, 21, 22, 23, 24, 25, 27, 28, 29, 31, 32, 35, 36, 40, 43, 44, 45, 46, 47, 48, 49, 50, 51, 52, 53, 54, 55, 58, 60, 61, 62, 65, 66, 67, 68, 69, 70, 71, 72, 73, 74, 75, 76, 78, 79, 81, 82, 84, 85, 86, 87, 88, 89, 90, 91, 94, 97, 98, 99, 102, 103, 104, 105, 106, 107, 108, 109, 110, 111, 112, 113, 114, 115, 119, 120, 121, 123, 124, 126, 127, 128, 129, 130, 131]"
docusaurus,16667,881,778,103,"[5, 6, 7, 8, 29, 30, 31, 34, 35, 37, 38, 40, 42, 43, 44, 45, 46, 47, 51, 52, 56, 58, 65, 72, 73, 74, 75, 76, 77, 78, 82, 83, 85, 86, 87, 89, 90, 95, 96, 97, 99, 101, 102, 103, 104, 120, 123, 124, 125, 129, 139, 143, 144, 178, 183, 188, 190, 205, 207, 210, 212, 213, 218, 219, 220, 221, 227, 228, 232, 234, 235, 236, 237, 238, 240, 242, 243, 245, 246, 247, 248, 249, 251, 253, 254, 257, 263, 264, 267, 268, 269, 274, 290, 292, 297, 300, 301, 305, 307, 308]"
jquery-pjax,16636,441,386,55,"[1, 2, 3, 4, 5, 6, 8, 10, 13, 14, 15, 16, 17, 19, 28, 29, 31, 34, 36, 37, 38, 40, 42, 43, 46, 47, 48, 51, 58, 59, 61, 63, 66, 67, 68, 70, 71, 72, 75, 77, 81, 82, 85, 88, 89, 90, 97, 98, 100, 102, 104, 106, 107, 108, 110, 116, 117, 119, 120, 124, 125, 126, 129, 131, 132, 133, 136, 137, 138, 139, 140, 141, 142, 143, 145, 147, 150, 152, 156, 157, 158, 159, 161, 162, 163, 164, 165, 166, 167, 168, 169, 170, 176, 178, 179, 180, 181, 182, 183, 184]"
reselect,16619,297,234,63,"[1, 5, 7, 8, 11, 13, 14, 15, 16, 17, 18, 20, 22, 23, 24, 25, 26, 27, 29, 30, 31, 34, 36, 37, 38, 39, 41, 42, 43, 47, 51, 54, 55, 56, 58, 62, 63, 64, 66, 67, 71, 73, 74, 75, 76, 77, 79, 81, 82, 83, 84, 87, 88, 89, 93, 97, 98, 99, 100, 101, 102, 103, 104, 105, 109, 114, 118, 122, 124, 125, 126, 128, 129, 130, 132, 134, 136, 137, 138, 139, 140, 141, 142, 145, 146, 149, 150, 151, 154, 155, 157, 159, 160, 162, 163, 165, 166, 168, 169, 170]"
Mask_RCNN,16613,1948,631,1317,"[1, 2, 4, 5, 6, 7, 8, 11, 13, 14, 15, 16, 17, 18, 19, 21, 22, 23, 24, 25, 26, 27, 28, 29, 30, 31, 33, 34, 36, 37, 39, 40, 41, 42, 43, 44, 46, 47, 49, 50, 51, 52, 53, 54, 55, 56, 58, 59, 60, 61, 62, 63, 65, 66, 67, 69, 72, 73, 74, 76, 77, 78, 79, 80, 81, 82, 83, 84, 85, 86, 87, 88, 89, 90, 91, 92, 93, 94, 95, 96, 97, 98, 99, 100, 102, 103, 104, 105, 106, 108, 109, 110, 111, 112, 113, 114, 115, 116, 117, 119]"
airflow,16603,1085,805,280,"[3, 4, 6, 7, 8, 9, 12, 13, 16, 17, 18, 20, 21, 22, 23, 27, 30, 37, 39, 40, 41, 42, 45, 46, 47, 48, 50, 51, 52, 55, 56, 57, 58, 59, 61, 63, 66, 70, 72, 73, 75, 77, 80, 81, 87, 88, 92, 93, 95, 102, 110, 112, 113, 115, 116, 119, 120, 121, 122, 123, 124, 125, 128, 130, 133, 135, 136, 137, 138, 139, 140, 142, 144, 148, 149, 150, 157, 161, 163, 165, 167, 168, 170, 171, 174, 182, 184, 187, 188, 190, 191, 192, 193, 195, 196, 197, 198, 199, 202, 203]"
drawio,16594,797,551,246,"[1, 2, 3, 4, 5, 6, 7, 8, 9, 10, 11, 15, 16, 17, 18, 20, 21, 22, 23, 24, 25, 26, 27, 28, 29, 30, 31, 32, 34, 35, 36, 37, 38, 39, 40, 41, 43, 44, 45, 46, 47, 48, 50, 51, 52, 53, 54, 55, 56, 57, 58, 59, 60, 61, 62, 63, 64, 65, 66, 67, 68, 69, 72, 73, 74, 75, 76, 77, 78, 79, 80, 81, 82, 83, 84, 85, 86, 87, 88, 91, 92, 93, 95, 96, 97, 98, 99, 100, 101, 103, 104, 105, 106, 107, 108, 109, 110, 111, 112, 113]"
material,16591,8925,8502,423,"[1, 2, 3, 4, 5, 6, 7, 8, 9, 10, 11, 12, 13, 14, 15, 16, 17, 18, 19, 20, 21, 22, 23, 24, 26, 27, 28, 29, 30, 31, 32, 33, 34, 35, 36, 37, 38, 40, 41, 42, 43, 44, 45, 47, 48, 49, 50, 51, 52, 53, 54, 55, 56, 57, 58, 59, 60, 61, 62, 63, 64, 65, 66, 67, 69, 70, 71, 72, 73, 74, 75, 76, 77, 78, 79, 80, 81, 82, 83, 84, 85, 86, 88, 89, 90, 92, 93, 94, 95, 98, 100, 102, 104, 105, 106, 107, 109, 110, 111, 112]"
velocity,16588,801,763,38,"[1, 2, 3, 4, 5, 6, 7, 8, 9, 10, 11, 13, 14, 15, 16, 17, 18, 20, 21, 23, 24, 26, 27, 30, 31, 32, 34, 35, 36, 37, 38, 39, 40, 41, 42, 43, 44, 45, 46, 47, 48, 50, 53, 54, 55, 56, 57, 58, 59, 60, 61, 62, 63, 64, 65, 66, 67, 68, 69, 70, 71, 72, 73, 74, 75, 76, 77, 79, 81, 84, 85, 88, 89, 90, 91, 92, 93, 94, 95, 96, 97, 99, 100, 102, 104, 105, 106, 108, 109, 110, 111, 112, 113, 114, 115, 116, 117, 118, 119, 120]"
rocksdb,16573,1924,1582,342,"[1, 2, 4, 6, 7, 8, 9, 10, 11, 12, 13, 14, 17, 19, 20, 21, 22, 23, 25, 26, 27, 30, 34, 36, 38, 39, 40, 41, 42, 43, 44, 45, 46, 49, 50, 52, 53, 54, 55, 57, 60, 64, 65, 66, 67, 69, 70, 72, 73, 75, 79, 80, 81, 83, 88, 89, 91, 92, 93, 95, 96, 98, 100, 101, 102, 103, 104, 106, 109, 111, 112, 113, 114, 115, 116, 117, 118, 119, 123, 126, 127, 128, 129, 133, 135, 139, 140, 144, 145, 146, 147, 148, 149, 151, 152, 158, 159, 160, 161, 162]"
hhvm,16519,5717,4879,838,"[1, 2, 3, 4, 5, 6, 7, 8, 9, 10, 11, 12, 13, 14, 15, 16, 17, 18, 19, 20, 21, 22, 23, 24, 25, 26, 27, 28, 29, 30, 31, 32, 33, 34, 35, 36, 37, 38, 39, 40, 41, 42, 43, 44, 45, 46, 47, 48, 49, 50, 51, 52, 53, 54, 55, 56, 57, 58, 59, 60, 61, 62, 63, 64, 65, 66, 67, 68, 69, 70, 72, 73, 74, 75, 76, 77, 78, 79, 80, 81, 82, 83, 84, 85, 86, 87, 88, 89, 90, 91, 92, 93, 94, 95, 96, 97, 98, 99, 100, 101]"
graphql-engine,16516,2459,1642,817,"[5, 6, 7, 8, 10, 12, 13, 14, 16, 17, 20, 21, 23, 28, 29, 34, 36, 38, 40, 42, 44, 45, 46, 50, 51, 53, 55, 56, 57, 58, 59, 60, 61, 67, 68, 70, 72, 75, 77, 79, 80, 81, 85, 86, 87, 91, 92, 95, 96, 97, 98, 99, 102, 105, 106, 112, 113, 115, 116, 121, 122, 127, 130, 133, 134, 138, 139, 140, 141, 142, 143, 144, 146, 150, 151, 154, 159, 161, 164, 165, 171, 174, 175, 178, 180, 182, 184, 185, 186, 187, 189, 191, 192, 194, 195, 196, 198, 202, 204, 205]"
pytorch-tutorial,16505,154,109,45,"[3, 5, 6, 8, 9, 12, 13, 14, 15, 16, 17, 18, 19, 20, 21, 22, 23, 24, 26, 27, 29, 33, 34, 35, 37, 38, 39, 40, 41, 43, 44, 45, 46, 50, 51, 52, 53, 54, 55, 56, 57, 59, 60, 62, 63, 64, 65, 66, 67, 68, 70, 71, 72, 73, 74, 75, 77, 78, 79, 80, 81, 82, 83, 84, 85, 87, 89, 90, 91, 92, 93, 94, 95, 96, 98, 100, 101, 102, 103, 104, 105, 106, 109, 110, 111, 115, 116, 117, 118, 122, 123, 124, 125, 126, 127, 130, 131, 133, 134, 135]"
tips,16472,27,15,12,"[3, 25, 29, 42, 46, 47, 48, 53, 54, 69, 78, 82, 99, 109, 112, 116, 127, 146, 147, 149, 151, 157, 158, 161, 163, 177, 182]"
react-native-web,16457,1180,1094,86,"[1, 2, 5, 6, 7, 8, 9, 10, 11, 12, 13, 14, 15, 16, 17, 18, 19, 23, 24, 25, 26, 27, 28, 29, 30, 31, 32, 33, 34, 36, 38, 39, 40, 41, 42, 44, 45, 46, 47, 48, 49, 50, 51, 52, 53, 54, 55, 56, 57, 58, 60, 61, 62, 63, 65, 66, 67, 68, 71, 72, 73, 74, 76, 78, 81, 83, 88, 89, 90, 91, 92, 93, 95, 96, 97, 98, 99, 100, 101, 102, 103, 104, 105, 106, 107, 108, 110, 112, 114, 115, 116, 117, 118, 119, 121, 122, 123, 124, 127, 128]"
stackedit,16395,1502,962,540,"[1, 3, 4, 5, 6, 7, 8, 9, 10, 11, 12, 13, 14, 15, 16, 17, 18, 19, 20, 21, 22, 23, 24, 25, 26, 27, 28, 29, 30, 31, 32, 33, 34, 35, 36, 37, 38, 39, 40, 41, 42, 43, 44, 45, 46, 47, 48, 49, 50, 51, 53, 54, 55, 56, 58, 59, 60, 61, 62, 63, 64, 65, 66, 67, 68, 69, 70, 71, 72, 73, 74, 75, 76, 77, 78, 79, 80, 81, 82, 83, 84, 85, 86, 87, 88, 89, 90, 91, 92, 93, 94, 95, 96, 97, 98, 99, 100, 101, 102, 103]"
sharp,16391,1950,1867,83,"[1, 2, 3, 4, 5, 6, 7, 8, 9, 10, 12, 16, 17, 19, 21, 23, 24, 26, 27, 28, 29, 30, 31, 32, 33, 34, 35, 36, 37, 40, 41, 42, 43, 44, 45, 46, 47, 48, 50, 53, 54, 56, 57, 58, 59, 60, 62, 63, 64, 65, 66, 67, 69, 70, 71, 72, 73, 74, 75, 76, 77, 78, 79, 80, 81, 82, 84, 85, 86, 88, 89, 90, 92, 93, 95, 96, 97, 98, 99, 100, 103, 104, 105, 108, 109, 110, 112, 113, 114, 115, 116, 117, 118, 119, 120, 121, 122, 123, 125, 126]"
SnapKit,16380,482,417,65,"[1, 2, 3, 4, 5, 6, 8, 12, 13, 14, 18, 19, 20, 21, 22, 23, 25, 26, 29, 30, 32, 33, 34, 38, 40, 41, 42, 44, 45, 48, 49, 52, 53, 54, 57, 58, 59, 60, 61, 62, 63, 64, 66, 67, 72, 73, 74, 77, 79, 81, 82, 83, 84, 85, 86, 87, 90, 91, 92, 93, 94, 95, 96, 98, 99, 100, 101, 102, 103, 105, 106, 107, 109, 110, 113, 116, 117, 120, 123, 124, 125, 126, 128, 129, 130, 131, 132, 133, 134, 135, 136, 138, 140, 141, 142, 144, 145, 146, 147, 148]"
Coursera-ML-AndrewNg-Notes,16357,44,10,34,"[1, 2, 4, 5, 6, 7, 8, 10, 12, 15, 17, 20, 21, 22, 23, 24, 25, 26, 27, 29, 30, 31, 32, 34, 35, 36, 37, 38, 39, 41, 43, 46, 47, 51, 52, 53, 54, 56, 57, 58, 60, 61, 62, 63]"
CS-Interview-Knowledge-Map,16344,101,74,27,"[1, 2, 3, 4, 5, 6, 7, 8, 9, 10, 11, 12, 13, 14, 15, 16, 17, 18, 19, 20, 21, 23, 26, 31, 34, 38, 39, 41, 44, 46, 47, 50, 52, 57, 63, 65, 67, 68, 69, 71, 72, 73, 74, 75, 76, 81, 82, 88, 91, 94, 95, 96, 97, 98, 101, 103, 105, 106, 108, 112, 119, 120, 125, 130, 131, 134, 141, 149, 150, 151, 152, 153, 154, 157, 158, 159, 160, 161, 163, 164, 166, 167, 168, 169, 172, 173, 174, 175, 181, 182, 183, 184, 186, 187, 189, 190, 192, 194, 195, 196]"
highlight.js,16343,1325,1282,43,"[10, 11, 12, 13, 17, 18, 21, 22, 23, 25, 28, 29, 30, 31, 32, 33, 34, 36, 37, 38, 42, 45, 47, 48, 49, 54, 57, 59, 60, 61, 63, 66, 70, 72, 73, 75, 77, 80, 81, 82, 90, 91, 92, 98, 99, 102, 105, 108, 109, 110, 111, 112, 116, 117, 118, 119, 128, 134, 135, 137, 139, 143, 144, 146, 147, 149, 151, 152, 153, 154, 156, 158, 159, 160, 164, 165, 174, 175, 177, 179, 181, 182, 184, 185, 187, 188, 189, 191, 192, 193, 194, 200, 201, 205, 206, 207, 208, 209, 210, 213]"
spaCy,16327,3926,3734,192,"[1, 7, 9, 10, 11, 12, 13, 14, 15, 16, 17, 18, 19, 20, 22, 23, 24, 25, 26, 27, 29, 30, 31, 32, 35, 36, 37, 38, 39, 40, 41, 42, 43, 44, 45, 46, 47, 48, 49, 50, 51, 52, 53, 54, 56, 57, 58, 59, 60, 61, 62, 63, 64, 65, 67, 68, 69, 70, 71, 72, 74, 75, 76, 77, 78, 79, 80, 81, 82, 83, 84, 87, 88, 89, 90, 91, 92, 93, 94, 95, 96, 97, 98, 100, 102, 103, 105, 106, 108, 109, 112, 113, 114, 115, 116, 118, 119, 120, 121, 122]"
immer,16324,366,344,22,"[2, 3, 4, 5, 6, 7, 8, 10, 12, 18, 23, 24, 26, 27, 29, 30, 31, 32, 34, 35, 36, 41, 42, 43, 45, 46, 47, 48, 49, 50, 51, 52, 53, 54, 57, 58, 60, 61, 62, 65, 66, 67, 72, 74, 75, 77, 80, 83, 84, 86, 89, 91, 92, 93, 94, 95, 96, 97, 100, 101, 102, 103, 105, 107, 108, 110, 111, 115, 116, 117, 119, 120, 129, 130, 132, 133, 134, 136, 138, 141, 142, 143, 146, 147, 148, 150, 151, 153, 155, 159, 160, 162, 163, 164, 165, 166, 169, 171, 174, 175]"
less.js,16298,2643,2498,145,"[1, 2, 3, 4, 5, 6, 7, 8, 9, 10, 11, 12, 13, 14, 15, 16, 17, 18, 19, 20, 21, 22, 23, 24, 25, 26, 27, 28, 29, 30, 31, 32, 33, 34, 35, 36, 37, 38, 39, 40, 41, 42, 43, 44, 45, 46, 47, 48, 49, 50, 51, 52, 53, 54, 55, 56, 57, 58, 59, 60, 61, 62, 63, 64, 65, 66, 67, 68, 69, 70, 71, 72, 73, 74, 75, 76, 77, 78, 79, 80, 81, 82, 83, 84, 85, 86, 87, 88, 89, 90, 91, 92, 93, 94, 95, 96, 97, 98, 99, 100]"
eslint,16285,7830,7693,137,"[1, 2, 3, 4, 5, 6, 7, 8, 9, 10, 11, 12, 13, 14, 15, 16, 18, 19, 20, 21, 28, 29, 30, 31, 32, 36, 43, 45, 48, 53, 56, 57, 58, 63, 66, 68, 69, 70, 76, 78, 82, 84, 90, 94, 99, 102, 103, 107, 110, 112, 115, 119, 121, 123, 124, 129, 132, 136, 138, 140, 143, 145, 147, 148, 149, 151, 152, 154, 156, 158, 159, 161, 163, 167, 170, 171, 175, 177, 180, 181, 183, 185, 187, 189, 190, 192, 199, 200, 205, 209, 210, 212, 214, 217, 219, 221, 224, 226, 228, 229]"
idiomatic.js,16275,75,44,31,"[2, 3, 4, 5, 6, 8, 13, 14, 15, 17, 19, 20, 23, 30, 31, 33, 34, 35, 45, 47, 48, 52, 57, 60, 61, 67, 72, 73, 76, 79, 84, 86, 87, 88, 93, 94, 96, 98, 100, 102, 105, 114, 115, 117, 119, 123, 125, 126, 130, 131, 134, 136, 138, 150, 151, 155, 160, 163, 165, 169, 172, 177, 185, 189, 190, 191, 192, 193, 195, 213, 224, 229, 230, 239, 241]"
apollo,16267,2261,1639,622,"[11, 13, 14, 15, 16, 17, 18, 20, 22, 28, 45, 46, 47, 50, 51, 52, 53, 54, 55, 56, 57, 58, 59, 61, 75, 77, 79, 80, 81, 82, 97, 99, 101, 103, 105, 107, 109, 110, 116, 120, 124, 126, 127, 129, 131, 132, 136, 137, 138, 139, 140, 152, 153, 154, 156, 157, 158, 159, 166, 171, 174, 176, 181, 183, 189, 196, 198, 199, 200, 201, 212, 218, 219, 235, 244, 245, 246, 247, 251, 253, 255, 256, 258, 261, 266, 267, 268, 269, 271, 275, 276, 278, 279, 281, 284, 285, 286, 288, 292, 293]"
gfwlist,16246,1923,1392,531,"[1, 2, 3, 4, 5, 6, 7, 8, 9, 10, 11, 12, 13, 14, 15, 16, 17, 18, 19, 20, 21, 22, 23, 24, 25, 26, 27, 28, 29, 30, 31, 32, 33, 34, 35, 36, 37, 38, 39, 40, 41, 42, 43, 44, 45, 46, 48, 49, 50, 51, 52, 53, 54, 55, 56, 57, 58, 59, 60, 61, 62, 63, 64, 65, 66, 67, 68, 69, 70, 71, 72, 73, 74, 75, 76, 77, 78, 79, 81, 82, 83, 84, 85, 86, 87, 88, 89, 90, 91, 92, 93, 94, 95, 96, 97, 98, 99, 100, 101, 102]"
vuepress,16238,1434,1185,249,"[2, 5, 6, 8, 9, 10, 12, 19, 20, 21, 26, 28, 31, 33, 34, 35, 36, 37, 39, 40, 41, 42, 45, 49, 50, 51, 52, 53, 54, 55, 56, 57, 58, 59, 62, 63, 67, 68, 69, 70, 71, 72, 74, 75, 76, 77, 78, 79, 83, 84, 86, 87, 89, 91, 92, 93, 94, 95, 98, 99, 100, 101, 102, 103, 104, 105, 106, 107, 108, 109, 110, 111, 112, 113, 114, 117, 118, 120, 121, 122, 123, 124, 125, 128, 131, 133, 134, 135, 137, 139, 140, 141, 142, 143, 144, 145, 146, 147, 150, 157]"
vue-router,16230,2384,2266,118,"[1, 2, 3, 4, 5, 6, 7, 8, 10, 11, 13, 14, 16, 17, 18, 19, 20, 21, 23, 24, 25, 26, 27, 28, 29, 30, 31, 32, 33, 34, 35, 36, 37, 38, 39, 40, 41, 43, 45, 46, 47, 48, 49, 51, 52, 54, 55, 56, 57, 58, 59, 60, 61, 62, 63, 64, 65, 66, 68, 69, 70, 71, 72, 73, 74, 75, 76, 77, 78, 79, 81, 82, 83, 84, 85, 86, 88, 89, 90, 91, 92, 93, 94, 95, 96, 97, 100, 102, 103, 109, 110, 112, 113, 114, 115, 117, 118, 129, 130, 131]"
Micro8,16208,40,30,10,"[1, 2, 3, 4, 5, 6, 7, 8, 9, 10, 12, 13, 14, 15, 16, 17, 18, 19, 20, 21, 22, 23, 24, 25, 26, 27, 29, 32, 37, 41, 42, 44, 45, 46, 48, 49, 52, 53, 55, 56]"
lazygit,16205,425,325,100,"[1, 3, 4, 5, 6, 7, 8, 9, 10, 11, 12, 14, 15, 16, 17, 21, 22, 23, 24, 25, 26, 27, 28, 30, 32, 33, 37, 38, 39, 41, 42, 43, 44, 45, 46, 48, 49, 51, 52, 55, 56, 57, 58, 59, 61, 64, 67, 68, 70, 71, 72, 73, 74, 75, 76, 78, 79, 81, 82, 84, 87, 88, 89, 90, 91, 92, 95, 96, 97, 99, 100, 101, 103, 106, 108, 109, 111, 113, 119, 121, 122, 125, 126, 128, 130, 131, 134, 136, 138, 139, 141, 144, 145, 147, 148, 149, 152, 153, 154, 155]"
source-code-pro,16196,186,141,45,"[3, 4, 6, 8, 9, 10, 11, 12, 13, 14, 16, 17, 18, 19, 20, 22, 23, 24, 25, 26, 28, 30, 31, 32, 36, 38, 39, 42, 43, 44, 48, 49, 51, 52, 57, 58, 60, 61, 63, 64, 65, 66, 67, 68, 69, 72, 73, 74, 75, 76, 77, 78, 79, 80, 81, 83, 84, 85, 86, 87, 88, 89, 90, 91, 92, 93, 94, 95, 96, 97, 98, 100, 101, 102, 103, 105, 107, 108, 109, 110, 111, 114, 115, 116, 117, 118, 119, 120, 121, 122, 123, 124, 126, 127, 128, 129, 130, 131, 132, 134]"
fresco,16152,2099,1994,105,"[3, 4, 5, 6, 7, 8, 9, 10, 11, 12, 13, 14, 15, 16, 17, 18, 19, 20, 22, 23, 24, 25, 26, 27, 29, 30, 31, 33, 34, 35, 36, 37, 38, 39, 40, 41, 42, 43, 44, 45, 46, 47, 48, 49, 50, 51, 52, 55, 56, 57, 58, 60, 61, 62, 63, 64, 65, 66, 67, 68, 69, 71, 72, 73, 74, 75, 77, 78, 79, 80, 81, 82, 83, 84, 85, 86, 88, 89, 90, 91, 92, 93, 94, 95, 96, 97, 98, 99, 100, 101, 102, 103, 104, 105, 106, 107, 108, 109, 110, 111]"
iTerm2-Color-Schemes,16152,57,47,10,"[1, 6, 9, 18, 20, 23, 24, 28, 29, 30, 31, 32, 37, 43, 46, 47, 51, 52, 53, 58, 59, 62, 64, 66, 71, 78, 79, 80, 81, 85, 95, 98, 102, 106, 109, 119, 121, 124, 133, 138, 139, 140, 145, 149, 165, 177, 178, 179, 182, 193, 197, 198, 200, 210, 214, 217, 219]"
howler.js,16146,1106,767,339,"[1, 2, 3, 4, 5, 6, 8, 9, 11, 14, 15, 16, 19, 20, 21, 22, 23, 25, 27, 28, 29, 30, 31, 36, 37, 38, 39, 40, 41, 42, 44, 45, 47, 50, 51, 52, 54, 56, 57, 58, 59, 60, 61, 63, 64, 65, 66, 67, 68, 70, 71, 72, 74, 75, 76, 77, 78, 80, 81, 83, 84, 87, 88, 89, 90, 91, 92, 94, 95, 96, 98, 99, 100, 102, 103, 104, 105, 107, 108, 109, 110, 111, 112, 113, 114, 115, 116, 118, 119, 123, 124, 125, 128, 129, 132, 134, 135, 136, 138, 141]"
phpunit,16145,2678,2581,97,"[1, 2, 3, 4, 5, 6, 7, 8, 9, 10, 11, 12, 13, 14, 16, 17, 19, 20, 22, 24, 25, 26, 27, 28, 29, 30, 31, 32, 33, 34, 35, 38, 39, 40, 42, 43, 45, 46, 47, 53, 54, 55, 56, 57, 58, 59, 60, 61, 62, 63, 64, 65, 66, 69, 70, 71, 72, 74, 75, 76, 77, 78, 79, 80, 81, 82, 85, 89, 90, 91, 92, 93, 94, 95, 96, 97, 98, 99, 100, 101, 102, 104, 107, 108, 109, 111, 112, 113, 115, 116, 117, 119, 120, 123, 124, 125, 126, 127, 129, 130]"
wekan,16113,2290,1730,560,"[1, 2, 3, 4, 5, 6, 7, 8, 9, 10, 11, 12, 13, 14, 15, 17, 18, 19, 20, 21, 22, 23, 24, 25, 26, 27, 28, 29, 30, 31, 32, 33, 34, 35, 36, 42, 43, 44, 46, 50, 51, 52, 53, 54, 55, 58, 61, 62, 63, 64, 65, 66, 67, 70, 71, 74, 75, 76, 77, 79, 80, 81, 82, 83, 85, 86, 87, 88, 90, 92, 93, 94, 95, 96, 97, 98, 99, 100, 101, 102, 103, 104, 105, 106, 107, 109, 110, 111, 112, 113, 114, 115, 116, 118, 119, 120, 121, 122, 123, 124]"
blueprint,16080,2097,1613,484,"[5, 6, 7, 8, 9, 11, 12, 14, 15, 20, 22, 28, 32, 34, 35, 39, 40, 47, 58, 59, 64, 78, 89, 91, 92, 93, 96, 98, 100, 101, 104, 105, 106, 108, 112, 116, 118, 122, 123, 125, 126, 128, 129, 131, 132, 133, 134, 137, 138, 139, 142, 144, 145, 147, 149, 150, 151, 152, 154, 163, 165, 166, 167, 168, 169, 172, 182, 183, 184, 185, 190, 191, 192, 193, 194, 197, 198, 200, 201, 202, 203, 204, 205, 213, 215, 216, 217, 218, 219, 222, 223, 224, 228, 230, 231, 232, 233, 234, 235, 236]"
typeahead.js,16060,1314,903,411,"[1, 2, 4, 5, 8, 9, 10, 11, 12, 14, 16, 17, 18, 19, 20, 21, 22, 23, 24, 27, 28, 30, 31, 32, 33, 35, 41, 42, 43, 44, 46, 49, 50, 53, 55, 56, 57, 61, 62, 63, 64, 65, 66, 67, 68, 69, 70, 71, 72, 73, 76, 78, 82, 83, 84, 86, 87, 88, 89, 90, 91, 92, 93, 94, 95, 96, 97, 98, 99, 101, 103, 104, 105, 107, 111, 114, 118, 119, 120, 122, 123, 126, 127, 130, 134, 135, 136, 140, 141, 142, 143, 144, 145, 146, 147, 148, 149, 150, 151, 153]"
Kingfisher,16060,932,878,54,"[2, 5, 7, 9, 10, 12, 13, 14, 18, 19, 24, 27, 29, 35, 36, 47, 49, 54, 56, 60, 61, 62, 64, 66, 67, 69, 70, 71, 73, 74, 75, 80, 84, 85, 86, 87, 92, 93, 94, 97, 99, 100, 101, 102, 103, 105, 106, 107, 111, 112, 113, 114, 117, 118, 119, 120, 121, 123, 124, 131, 132, 135, 137, 138, 139, 140, 142, 143, 145, 146, 149, 150, 159, 160, 161, 162, 163, 167, 169, 170, 173, 180, 181, 182, 183, 187, 188, 189, 191, 192, 193, 202, 203, 205, 211, 212, 213, 214, 215, 218]"
redash,16054,1883,1506,377,"[1, 2, 3, 4, 5, 6, 7, 8, 9, 10, 11, 12, 13, 14, 15, 16, 17, 18, 19, 20, 21, 22, 23, 24, 25, 26, 27, 28, 29, 30, 31, 32, 33, 34, 38, 39, 40, 41, 42, 43, 44, 45, 46, 49, 50, 51, 57, 58, 59, 60, 61, 62, 63, 64, 68, 75, 77, 78, 80, 81, 82, 85, 90, 91, 92, 97, 104, 106, 107, 113, 115, 117, 120, 121, 125, 129, 137, 138, 141, 144, 145, 146, 148, 158, 159, 160, 161, 162, 168, 171, 173, 174, 175, 177, 183, 184, 185, 186, 187, 188]"
generator-jhipster,16040,5778,5701,77,"[1, 2, 3, 4, 5, 6, 7, 8, 9, 10, 11, 12, 13, 14, 15, 16, 17, 18, 19, 26, 27, 28, 30, 31, 32, 33, 35, 36, 37, 38, 39, 44, 45, 47, 48, 49, 50, 52, 53, 60, 61, 65, 66, 67, 68, 69, 70, 71, 72, 73, 75, 76, 78, 79, 80, 82, 84, 85, 86, 87, 88, 89, 96, 98, 99, 104, 105, 106, 107, 110, 114, 115, 118, 119, 120, 121, 122, 124, 125, 128, 130, 134, 137, 139, 145, 146, 147, 151, 152, 155, 156, 163, 164, 167, 172, 173, 177, 178, 182, 183]"
graphql-js,16017,817,736,81,"[13, 14, 16, 17, 19, 20, 21, 22, 23, 25, 26, 27, 28, 32, 33, 38, 41, 44, 45, 48, 50, 51, 52, 53, 55, 56, 58, 69, 73, 78, 81, 82, 91, 92, 93, 95, 96, 99, 100, 102, 103, 104, 106, 109, 110, 111, 112, 113, 114, 115, 121, 122, 123, 126, 130, 133, 134, 135, 138, 143, 144, 146, 148, 149, 150, 151, 152, 154, 155, 156, 158, 159, 161, 164, 166, 168, 169, 170, 173, 176, 179, 181, 182, 183, 185, 187, 188, 192, 193, 194, 196, 198, 202, 205, 206, 207, 208, 209, 210, 211]"
vhr,16007,186,80,106,"[1, 2, 3, 4, 5, 6, 7, 8, 9, 10, 11, 12, 13, 14, 15, 16, 17, 18, 19, 20, 21, 22, 23, 24, 25, 26, 27, 28, 29, 30, 31, 32, 33, 34, 35, 36, 37, 38, 39, 40, 41, 42, 43, 44, 45, 46, 47, 48, 49, 50, 51, 52, 55, 56, 57, 58, 59, 60, 61, 62, 63, 64, 65, 66, 67, 68, 70, 71, 72, 73, 74, 75, 76, 77, 78, 79, 82, 83, 84, 85, 87, 88, 89, 90, 91, 92, 93, 94, 95, 96, 97, 98, 99, 100, 101, 102, 103, 104, 105, 106]"
ML-From-Scratch,15972,53,33,20,"[1, 2, 3, 5, 6, 7, 8, 9, 10, 11, 12, 13, 14, 15, 16, 17, 18, 22, 23, 26, 27, 28, 29, 30, 32, 33, 34, 35, 38, 39, 40, 41, 42, 44, 45, 46, 49, 52, 55, 58, 59, 61, 62, 66, 67, 68, 69, 71, 72, 74, 75, 76, 77]"
servo,15903,10941,7790,3151,"[1, 2, 3, 4, 5, 7, 14, 20, 21, 22, 23, 24, 30, 32, 34, 35, 36, 37, 38, 40, 41, 42, 43, 44, 45, 46, 47, 48, 49, 50, 51, 54, 55, 56, 57, 58, 59, 60, 61, 62, 63, 64, 65, 66, 67, 68, 69, 70, 71, 72, 73, 74, 75, 76, 77, 78, 79, 80, 81, 82, 83, 84, 85, 86, 87, 88, 89, 90, 91, 92, 93, 94, 95, 96, 97, 98, 99, 100, 101, 102, 103, 104, 105, 106, 107, 108, 109, 110, 111, 112, 113, 114, 115, 116, 117, 118, 119, 120, 121, 122]"
glances,15883,1201,1045,156,"[1, 2, 3, 4, 5, 6, 7, 9, 10, 11, 12, 13, 14, 15, 16, 17, 18, 19, 20, 21, 22, 23, 24, 26, 27, 28, 29, 30, 31, 32, 33, 34, 35, 36, 37, 38, 39, 41, 44, 45, 47, 49, 50, 52, 53, 54, 55, 56, 57, 59, 61, 62, 63, 64, 67, 68, 69, 72, 73, 74, 76, 77, 80, 82, 83, 84, 86, 87, 89, 90, 92, 93, 94, 95, 96, 97, 99, 102, 105, 106, 109, 110, 111, 112, 113, 114, 115, 116, 117, 120, 121, 124, 125, 127, 128, 129, 132, 133, 134, 136]"
black,15866,959,684,275,"[1, 2, 3, 4, 5, 6, 7, 8, 9, 13, 14, 15, 16, 17, 18, 19, 20, 21, 22, 23, 26, 27, 28, 30, 31, 32, 33, 34, 35, 37, 39, 40, 41, 42, 43, 44, 45, 46, 47, 48, 49, 51, 52, 53, 54, 55, 56, 57, 58, 59, 60, 61, 62, 63, 64, 65, 66, 67, 68, 69, 70, 72, 73, 74, 78, 80, 84, 85, 86, 87, 90, 91, 93, 95, 98, 99, 100, 102, 103, 108, 109, 111, 112, 113, 116, 117, 118, 119, 120, 121, 122, 124, 125, 127, 129, 130, 132, 133, 134, 135]"
react-native-guide,15860,19,18,1,"[4, 5, 6, 9, 24, 31, 39, 44, 47, 50, 52, 53, 57, 58, 59, 66, 69, 71, 74]"
wenyan,15859,434,284,150,"[1, 2, 3, 4, 5, 6, 7, 8, 9, 10, 11, 12, 13, 14, 15, 16, 17, 18, 19, 20, 21, 23, 24, 26, 27, 28, 30, 31, 32, 34, 36, 37, 38, 39, 40, 41, 42, 43, 44, 46, 47, 48, 49, 50, 51, 52, 53, 55, 56, 57, 58, 59, 62, 63, 64, 65, 66, 67, 68, 69, 71, 72, 73, 74, 75, 76, 77, 78, 79, 80, 81, 83, 84, 85, 86, 87, 88, 91, 92, 93, 94, 95, 96, 97, 98, 99, 100, 101, 102, 103, 104, 105, 106, 107, 108, 109, 110, 111, 112, 113]"
macOS-Security-and-Privacy-Guide,15790,214,212,2,"[1, 2, 5, 7, 9, 10, 11, 12, 13, 16, 17, 18, 19, 20, 21, 24, 25, 29, 30, 32, 34, 35, 37, 38, 39, 40, 41, 44, 49, 50, 51, 52, 53, 54, 55, 56, 57, 58, 61, 63, 64, 65, 66, 67, 70, 71, 72, 73, 77, 80, 85, 86, 88, 89, 90, 91, 92, 93, 94, 96, 97, 98, 99, 100, 101, 102, 105, 106, 107, 110, 111, 112, 113, 114, 115, 116, 117, 118, 119, 120, 122, 123, 124, 125, 130, 131, 132, 133, 137, 138, 139, 140, 141, 142, 143, 144, 145, 148, 150, 151]"
pkg,15788,799,312,487,"[3, 4, 21, 22, 23, 35, 36, 37, 38, 39, 40, 41, 42, 43, 44, 45, 46, 47, 48, 49, 50, 51, 52, 53, 54, 55, 57, 58, 61, 62, 63, 64, 65, 66, 67, 68, 69, 71, 72, 73, 74, 75, 76, 79, 80, 81, 82, 83, 84, 85, 86, 87, 88, 89, 90, 91, 93, 94, 95, 96, 97, 98, 99, 100, 101, 102, 103, 104, 105, 106, 107, 108, 109, 110, 111, 112, 113, 114, 115, 116, 117, 118, 119, 120, 121, 122, 123, 124, 125, 126, 127, 128, 129, 130, 131, 132, 133, 134, 135, 136]"
fks,15776,26,17,9,"[1, 9, 32, 33, 38, 41, 43, 68, 73, 74, 80, 91, 97, 115, 119, 120, 122, 124, 132, 133, 134, 137, 138, 139, 140, 144]"
fabric.js,15725,4520,4304,216,"[1, 2, 3, 5, 6, 7, 8, 9, 10, 11, 12, 13, 14, 15, 16, 17, 18, 19, 20, 21, 22, 23, 24, 25, 26, 27, 28, 29, 30, 32, 33, 34, 35, 36, 37, 38, 39, 40, 41, 42, 43, 44, 45, 47, 48, 49, 50, 51, 53, 54, 55, 56, 57, 58, 60, 61, 62, 63, 64, 65, 66, 67, 68, 70, 71, 72, 73, 74, 75, 76, 77, 78, 79, 80, 81, 82, 83, 84, 87, 89, 90, 92, 93, 94, 95, 96, 97, 98, 99, 100, 101, 102, 103, 107, 108, 110, 111, 112, 113, 114]"
mint-ui,15708,1213,980,233,"[32, 51, 52, 54, 55, 56, 57, 58, 61, 62, 63, 65, 68, 69, 73, 74, 77, 82, 83, 91, 93, 94, 95, 96, 97, 99, 100, 101, 104, 105, 106, 107, 108, 109, 110, 111, 112, 113, 114, 116, 117, 118, 119, 120, 121, 122, 123, 125, 130, 132, 133, 134, 135, 136, 137, 140, 142, 146, 147, 150, 151, 153, 154, 155, 158, 159, 160, 161, 164, 165, 166, 167, 169, 170, 171, 177, 178, 179, 180, 181, 184, 186, 197, 198, 199, 206, 211, 212, 214, 215, 222, 223, 231, 234, 235, 236, 238, 243, 244, 245]"
uikit,15695,3666,3105,561,"[1, 2, 3, 4, 6, 7, 8, 9, 10, 11, 12, 13, 14, 15, 16, 17, 18, 19, 20, 21, 22, 23, 24, 25, 26, 27, 28, 30, 31, 32, 33, 34, 35, 36, 37, 38, 39, 40, 41, 42, 43, 44, 45, 46, 47, 48, 49, 50, 51, 52, 53, 54, 55, 56, 57, 58, 59, 60, 62, 63, 64, 65, 66, 67, 68, 69, 70, 71, 72, 73, 74, 75, 76, 77, 78, 79, 81, 82, 85, 86, 87, 88, 89, 90, 91, 92, 93, 94, 95, 96, 97, 98, 99, 100, 101, 103, 104, 105, 106, 107]"
mojs,15683,174,119,55,"[6, 8, 10, 11, 12, 13, 14, 15, 16, 17, 18, 19, 20, 21, 22, 25, 26, 27, 28, 29, 30, 31, 32, 36, 37, 38, 39, 40, 41, 42, 44, 47, 48, 49, 50, 51, 52, 53, 54, 55, 58, 59, 60, 61, 62, 63, 64, 65, 66, 67, 68, 69, 70, 72, 73, 75, 76, 77, 78, 80, 81, 82, 86, 87, 88, 89, 90, 91, 92, 94, 95, 96, 97, 98, 99, 100, 102, 103, 104, 105, 107, 109, 110, 111, 112, 113, 114, 115, 116, 117, 118, 119, 120, 121, 122, 123, 124, 125, 126, 127]"
node-lessons,15669,125,43,82,"[2, 5, 8, 15, 16, 17, 19, 20, 21, 22, 23, 25, 27, 28, 29, 30, 32, 33, 34, 35, 36, 38, 40, 42, 43, 45, 46, 47, 48, 49, 52, 53, 54, 56, 57, 60, 62, 64, 65, 66, 67, 68, 69, 70, 73, 74, 75, 76, 77, 78, 79, 82, 83, 84, 85, 86, 87, 88, 89, 90, 91, 93, 94, 95, 97, 98, 99, 100, 101, 102, 103, 104, 105, 106, 107, 108, 109, 110, 111, 112, 113, 114, 115, 116, 117, 118, 119, 120, 121, 122, 123, 125, 126, 127, 128, 129, 130, 131, 133, 135]"
vault,15663,3590,3103,487,"[7, 9, 10, 13, 31, 37, 38, 41, 42, 43, 56, 59, 60, 62, 64, 65, 68, 70, 72, 74, 75, 77, 79, 80, 83, 88, 89, 91, 93, 94, 95, 96, 97, 98, 99, 100, 103, 106, 107, 108, 110, 111, 112, 114, 115, 116, 119, 120, 121, 122, 123, 124, 125, 126, 127, 128, 129, 130, 131, 132, 136, 140, 141, 142, 143, 147, 148, 150, 152, 153, 155, 156, 157, 158, 159, 162, 163, 164, 165, 167, 169, 170, 172, 173, 174, 176, 178, 180, 182, 185, 186, 189, 191, 193, 194, 195, 196, 197, 198, 203]"
awesome-tensorflow,15661,10,10,0,"[11, 20, 23, 72, 75, 84, 102, 113, 124, 126]"
ZeroNet,15661,1950,1343,607,"[1, 2, 3, 4, 5, 6, 7, 8, 9, 10, 11, 15, 16, 17, 18, 19, 20, 21, 22, 23, 24, 28, 29, 30, 31, 32, 34, 35, 39, 40, 41, 42, 43, 44, 45, 47, 48, 49, 51, 52, 54, 56, 57, 58, 59, 60, 61, 62, 63, 64, 65, 66, 67, 68, 69, 70, 71, 72, 73, 74, 75, 76, 77, 78, 79, 80, 81, 82, 83, 84, 85, 87, 88, 89, 90, 91, 92, 93, 94, 95, 97, 98, 99, 100, 101, 103, 104, 106, 107, 112, 114, 115, 116, 117, 122, 123, 125, 126, 127, 128]"
IntelliJ-IDEA-Tutorial,15657,67,66,1,"[11, 12, 13, 14, 15, 16, 22, 24, 26, 27, 28, 29, 30, 31, 32, 33, 34, 40, 44, 45, 46, 49, 51, 52, 53, 56, 58, 59, 63, 64, 65, 66, 68, 69, 70, 72, 75, 78, 81, 84, 85, 86, 87, 88, 90, 91, 94, 95, 96, 100, 101, 104, 105, 110, 112, 115, 116, 117, 118, 119, 120, 121, 123, 124, 125, 128, 131]"
kafka,15643,0,0,0,[]
anko,15642,616,377,239,"[3, 4, 5, 7, 9, 10, 11, 12, 13, 14, 15, 16, 17, 18, 19, 20, 21, 23, 24, 25, 26, 27, 28, 29, 30, 31, 32, 33, 35, 37, 38, 39, 43, 45, 47, 48, 49, 50, 54, 55, 58, 60, 61, 64, 65, 66, 67, 68, 69, 70, 71, 72, 73, 74, 75, 76, 77, 78, 79, 81, 82, 83, 84, 85, 87, 88, 90, 91, 92, 95, 98, 101, 104, 105, 107, 108, 109, 110, 111, 113, 114, 115, 116, 117, 118, 119, 120, 121, 122, 123, 127, 128, 129, 130, 131, 132, 133, 135, 136, 137]"
miaosha,15628,43,29,14,"[1, 3, 4, 5, 6, 8, 9, 10, 11, 12, 13, 14, 15, 17, 18, 20, 21, 22, 23, 29, 31, 34, 37, 40, 41, 42, 44, 47, 48, 49, 50, 57, 58, 60, 61, 63, 64, 70, 72, 73, 75, 77, 78]"
marktext,15624,1313,993,320,"[1, 2, 3, 4, 5, 6, 8, 9, 12, 13, 15, 16, 17, 19, 20, 22, 23, 24, 27, 30, 31, 32, 33, 34, 35, 36, 37, 39, 40, 41, 42, 43, 44, 45, 48, 49, 51, 52, 54, 55, 56, 58, 62, 63, 64, 65, 67, 68, 70, 71, 76, 78, 79, 80, 81, 83, 84, 86, 87, 88, 90, 91, 94, 95, 97, 100, 101, 104, 105, 106, 107, 110, 111, 112, 113, 114, 116, 124, 125, 126, 127, 128, 129, 130, 131, 134, 135, 138, 140, 141, 142, 143, 144, 148, 149, 150, 151, 152, 153, 159]"
MBProgressHUD,15618,378,334,44,"[1, 2, 4, 10, 12, 14, 19, 21, 22, 24, 25, 26, 28, 35, 38, 42, 47, 49, 51, 53, 54, 56, 57, 58, 59, 60, 62, 64, 65, 66, 70, 72, 73, 74, 76, 77, 80, 81, 85, 88, 91, 94, 96, 97, 98, 100, 102, 107, 110, 113, 114, 116, 117, 118, 119, 121, 122, 126, 127, 128, 129, 130, 131, 132, 133, 136, 138, 141, 143, 144, 147, 150, 151, 152, 153, 155, 156, 159, 161, 162, 164, 165, 170, 171, 173, 174, 175, 176, 177, 181, 183, 184, 185, 187, 189, 191, 194, 196, 197, 198]"
RedisDesktopManager,15589,4276,4232,44,"[1, 2, 3, 4, 5, 6, 7, 8, 9, 10, 11, 12, 13, 14, 15, 16, 17, 18, 19, 20, 21, 22, 23, 24, 25, 26, 27, 28, 29, 30, 31, 32, 33, 34, 35, 36, 37, 38, 39, 40, 41, 42, 43, 44, 45, 46, 47, 48, 49, 50, 51, 52, 53, 54, 55, 56, 57, 58, 59, 60, 61, 62, 63, 64, 65, 66, 67, 68, 69, 70, 71, 72, 73, 74, 75, 76, 77, 78, 79, 80, 81, 83, 84, 85, 86, 87, 88, 89, 90, 91, 92, 93, 94, 95, 96, 97, 98, 99, 101, 102]"
joplin,15585,2259,2053,206,"[1, 2, 3, 4, 5, 6, 7, 8, 9, 10, 11, 12, 13, 14, 15, 16, 17, 18, 19, 20, 21, 22, 23, 24, 25, 26, 27, 28, 29, 30, 31, 32, 33, 34, 35, 36, 37, 38, 39, 42, 43, 44, 45, 46, 47, 48, 49, 50, 51, 52, 53, 54, 55, 56, 58, 59, 60, 61, 62, 63, 64, 65, 66, 67, 69, 70, 71, 72, 73, 74, 75, 76, 77, 78, 79, 80, 81, 83, 84, 85, 86, 87, 88, 89, 90, 91, 92, 93, 94, 96, 97, 98, 99, 100, 101, 102, 103, 104, 105, 107]"
cleave.js,15533,416,315,101,"[1, 2, 4, 7, 8, 9, 14, 16, 18, 19, 21, 24, 25, 27, 28, 29, 31, 32, 33, 34, 36, 37, 38, 39, 40, 42, 43, 45, 46, 48, 49, 50, 51, 52, 53, 54, 57, 58, 59, 61, 64, 67, 69, 71, 72, 73, 74, 75, 76, 77, 78, 79, 80, 81, 83, 84, 85, 89, 92, 93, 94, 95, 97, 98, 99, 100, 101, 102, 104, 105, 106, 108, 109, 110, 111, 113, 114, 115, 117, 118, 120, 121, 122, 123, 125, 128, 129, 131, 132, 133, 134, 135, 136, 138, 139, 140, 141, 142, 143, 144]"
coffeescript,15532,4054,4020,34,"[1, 2, 3, 4, 5, 6, 7, 8, 9, 10, 11, 12, 13, 14, 15, 16, 17, 18, 19, 20, 21, 22, 23, 24, 25, 26, 27, 28, 29, 30, 31, 32, 33, 34, 35, 36, 37, 38, 39, 40, 41, 42, 43, 44, 45, 46, 47, 48, 49, 50, 51, 52, 53, 54, 55, 56, 57, 58, 59, 60, 61, 62, 63, 64, 65, 66, 67, 68, 69, 70, 71, 72, 73, 74, 75, 76, 77, 78, 79, 80, 81, 82, 83, 84, 85, 86, 87, 88, 89, 90, 91, 92, 93, 94, 95, 96, 97, 98, 99, 100]"
swoole-src,15514,2374,2333,41,"[1, 2, 3, 4, 5, 6, 7, 8, 10, 11, 12, 14, 15, 17, 18, 20, 21, 22, 23, 25, 27, 29, 30, 31, 32, 33, 34, 43, 44, 46, 48, 49, 50, 51, 52, 53, 54, 55, 57, 59, 61, 62, 63, 64, 65, 66, 68, 69, 70, 73, 75, 76, 77, 78, 79, 81, 82, 83, 84, 85, 86, 88, 90, 91, 92, 94, 95, 98, 108, 109, 112, 113, 115, 118, 120, 125, 126, 130, 132, 133, 136, 137, 139, 140, 142, 143, 144, 150, 158, 159, 163, 165, 166, 170, 180, 182, 183, 184, 185, 186]"
NLP-progress,15498,78,57,21,"[4, 9, 16, 17, 26, 33, 34, 43, 45, 53, 58, 61, 67, 70, 74, 75, 76, 79, 82, 83, 90, 91, 100, 103, 104, 109, 113, 117, 128, 130, 147, 148, 154, 166, 169, 174, 183, 197, 200, 209, 211, 217, 220, 228, 229, 244, 246, 247, 254, 266, 268, 270, 275, 286, 289, 293, 304, 318, 325, 331, 341, 342, 358, 359, 361, 365, 380, 386, 405, 410, 411, 412, 417, 419, 434, 436, 437, 450]"
hubot,15490,746,683,63,"[1, 2, 3, 4, 7, 8, 9, 10, 11, 14, 15, 16, 17, 18, 20, 23, 24, 27, 28, 42, 44, 47, 48, 51, 53, 62, 63, 65, 66, 68, 71, 72, 73, 77, 78, 81, 84, 88, 89, 90, 91, 92, 95, 96, 97, 100, 102, 105, 107, 108, 109, 112, 114, 115, 116, 119, 122, 125, 130, 131, 132, 137, 139, 149, 151, 153, 155, 156, 157, 159, 160, 161, 163, 166, 169, 171, 180, 181, 185, 186, 187, 189, 197, 200, 201, 203, 205, 207, 212, 213, 214, 215, 216, 222, 223, 225, 226, 227, 230, 231]"
flexbox-layout,15485,270,200,70,"[1, 2, 7, 11, 13, 16, 18, 23, 32, 35, 36, 39, 44, 46, 47, 62, 63, 66, 71, 72, 77, 80, 81, 82, 84, 85, 86, 88, 90, 92, 93, 95, 96, 106, 109, 112, 115, 117, 130, 131, 138, 139, 152, 154, 156, 162, 170, 173, 182, 186, 192, 195, 196, 197, 198, 199, 200, 202, 204, 206, 208, 210, 211, 212, 215, 217, 220, 221, 222, 224, 228, 229, 236, 237, 238, 240, 242, 243, 244, 246, 247, 248, 249, 250, 253, 254, 261, 262, 263, 264, 265, 266, 268, 271, 273, 274, 275, 276, 277, 278]"
js-cookie,15480,409,406,3,"[6, 13, 18, 19, 25, 31, 35, 36, 37, 38, 39, 42, 43, 44, 45, 48, 49, 50, 51, 52, 53, 55, 56, 57, 58, 61, 63, 66, 69, 70, 72, 73, 74, 75, 76, 78, 79, 80, 81, 86, 87, 88, 89, 90, 92, 93, 94, 95, 96, 97, 98, 100, 101, 103, 104, 105, 106, 107, 108, 109, 111, 112, 113, 114, 115, 116, 117, 120, 121, 122, 124, 125, 126, 127, 128, 129, 130, 132, 133, 134, 135, 136, 137, 138, 139, 140, 143, 144, 145, 146, 148, 151, 152, 164, 166, 172, 173, 174, 175, 177]"
validator.js,15465,675,582,93,"[1, 2, 3, 4, 5, 6, 7, 9, 11, 12, 13, 15, 16, 18, 19, 21, 22, 23, 25, 31, 32, 34, 36, 40, 42, 44, 46, 48, 49, 50, 51, 52, 55, 56, 59, 60, 61, 62, 64, 65, 66, 67, 68, 69, 73, 74, 75, 76, 77, 78, 80, 82, 83, 85, 86, 87, 88, 91, 92, 94, 95, 97, 99, 101, 104, 105, 107, 108, 109, 111, 113, 115, 116, 117, 118, 119, 120, 121, 123, 124, 125, 126, 127, 128, 129, 130, 134, 135, 136, 137, 138, 139, 140, 142, 143, 144, 145, 146, 147, 149]"
ExoPlayer,15435,6447,6049,398,"[1, 2, 3, 4, 5, 6, 7, 8, 10, 11, 12, 14, 18, 19, 20, 21, 22, 23, 25, 26, 27, 28, 30, 31, 35, 36, 37, 38, 39, 40, 41, 44, 45, 46, 47, 48, 50, 51, 52, 54, 55, 56, 57, 58, 59, 61, 66, 67, 68, 69, 70, 71, 72, 73, 76, 77, 78, 79, 80, 81, 84, 85, 86, 87, 88, 89, 90, 91, 94, 95, 98, 101, 102, 103, 104, 105, 106, 107, 108, 109, 110, 111, 116, 118, 119, 120, 122, 123, 124, 125, 128, 129, 132, 133, 134, 135, 136, 139, 140, 141]"
seata,15431,1403,1152,251,"[6, 7, 9, 10, 11, 13, 14, 17, 20, 21, 22, 23, 25, 26, 27, 28, 29, 31, 32, 33, 34, 35, 36, 37, 39, 40, 41, 43, 44, 45, 46, 47, 49, 50, 52, 53, 54, 55, 56, 57, 58, 59, 61, 62, 63, 64, 65, 66, 68, 69, 71, 72, 73, 74, 75, 77, 78, 79, 81, 82, 85, 86, 87, 90, 92, 93, 95, 96, 97, 101, 103, 110, 114, 117, 120, 121, 122, 123, 126, 127, 135, 137, 139, 142, 143, 145, 147, 148, 149, 150, 152, 158, 161, 162, 163, 166, 167, 170, 171, 172]"
framework7,15408,3038,2939,99,"[2, 3, 4, 5, 7, 8, 11, 13, 16, 19, 20, 21, 23, 25, 26, 28, 29, 31, 33, 34, 35, 36, 38, 40, 41, 42, 43, 44, 46, 47, 48, 49, 50, 51, 52, 53, 54, 55, 56, 57, 58, 59, 60, 61, 62, 64, 65, 66, 67, 68, 69, 70, 71, 72, 73, 75, 76, 77, 78, 79, 80, 81, 83, 86, 87, 88, 89, 90, 91, 92, 93, 94, 95, 97, 98, 99, 100, 103, 104, 105, 106, 107, 108, 109, 110, 111, 112, 113, 114, 116, 117, 119, 120, 121, 122, 123, 124, 125, 126, 127]"
jenkins,15404,0,0,0,[]
100-Days-Of-ML-Code,15400,46,38,8,"[1, 5, 6, 9, 14, 18, 20, 24, 27, 30, 33, 34, 36, 37, 39, 40, 41, 42, 43, 44, 45, 49, 52, 55, 56, 57, 58, 59, 60, 61, 63, 70, 71, 73, 75, 79, 80, 82, 83, 84, 85, 88, 89, 92, 93, 94]"
egg,15385,3229,3102,127,"[1, 2, 3, 4, 5, 6, 8, 10, 11, 12, 13, 16, 18, 19, 23, 26, 27, 28, 29, 31, 32, 33, 34, 35, 36, 38, 39, 40, 41, 43, 45, 46, 47, 48, 49, 50, 51, 52, 53, 57, 58, 69, 70, 77, 82, 83, 84, 86, 90, 96, 97, 98, 99, 102, 103, 104, 105, 108, 109, 111, 112, 114, 115, 116, 117, 118, 122, 123, 124, 125, 126, 127, 129, 130, 131, 132, 134, 140, 142, 148, 149, 151, 152, 153, 156, 158, 159, 160, 161, 162, 166, 167, 168, 169, 170, 172, 173, 174, 175, 176]"
mysql,15380,1962,1837,125,"[1, 2, 3, 4, 5, 6, 7, 8, 9, 10, 11, 12, 13, 14, 15, 16, 17, 18, 20, 21, 22, 25, 26, 27, 28, 30, 32, 33, 34, 35, 36, 37, 38, 39, 41, 43, 44, 46, 47, 48, 49, 50, 51, 53, 57, 59, 60, 61, 62, 64, 67, 68, 69, 70, 71, 73, 74, 78, 79, 80, 81, 82, 83, 84, 86, 87, 89, 90, 92, 94, 95, 96, 97, 98, 99, 101, 102, 104, 106, 107, 108, 109, 110, 111, 112, 113, 114, 115, 116, 118, 120, 121, 125, 126, 128, 130, 132, 133, 134, 136]"
reddit,15362,0,0,0,[]
winston,15324,1147,859,288,"[1, 2, 3, 4, 5, 7, 9, 10, 11, 14, 15, 16, 19, 21, 22, 24, 25, 26, 29, 30, 31, 33, 35, 36, 38, 39, 41, 42, 43, 46, 47, 52, 55, 56, 57, 58, 59, 61, 62, 63, 65, 67, 68, 69, 71, 73, 74, 75, 76, 77, 78, 80, 82, 83, 84, 86, 88, 89, 90, 91, 92, 94, 95, 96, 100, 101, 104, 105, 107, 110, 111, 117, 121, 123, 125, 131, 134, 135, 136, 138, 139, 140, 150, 151, 152, 155, 157, 158, 161, 162, 164, 167, 168, 169, 171, 172, 173, 174, 175, 176]"
handlebars.js,15304,1223,1178,45,"[1, 3, 5, 6, 7, 9, 12, 13, 14, 15, 16, 17, 18, 19, 20, 21, 23, 26, 29, 30, 31, 32, 34, 36, 38, 40, 41, 43, 44, 45, 47, 51, 53, 54, 55, 56, 57, 58, 59, 60, 61, 62, 63, 64, 67, 70, 72, 75, 76, 77, 80, 82, 83, 84, 85, 87, 88, 89, 91, 92, 93, 94, 95, 97, 99, 100, 102, 104, 105, 106, 107, 108, 109, 110, 111, 115, 118, 119, 120, 122, 123, 124, 125, 126, 128, 129, 131, 133, 134, 136, 137, 138, 139, 140, 141, 142, 145, 146, 147, 148]"
zheng,15304,88,60,28,"[5, 17, 18, 19, 20, 23, 26, 29, 30, 40, 42, 47, 49, 50, 53, 58, 59, 60, 62, 64, 66, 68, 69, 71, 75, 76, 77, 80, 81, 83, 84, 86, 90, 92, 93, 95, 96, 97, 100, 102, 103, 104, 105, 106, 108, 109, 110, 112, 113, 114, 115, 116, 117, 118, 119, 120, 121, 123, 124, 125, 127, 128, 129, 130, 131, 132, 133, 135, 136, 137, 138, 140, 141, 146, 147, 148, 152, 154, 157, 158, 161, 163, 166, 170, 171, 173, 186, 187]"
iptv,15298,265,214,51,"[4, 5, 8, 9, 10, 11, 12, 14, 15, 16, 19, 24, 25, 26, 27, 28, 29, 30, 31, 32, 33, 34, 35, 36, 37, 38, 39, 68, 78, 81, 125, 126, 127, 133, 134, 155, 169, 174, 175, 176, 193, 219, 220, 221, 222, 233, 240, 275, 276, 303, 304, 308, 312, 313, 314, 337, 339, 340, 347, 355, 357, 359, 360, 361, 365, 366, 367, 368, 378, 379, 385, 386, 391, 392, 398, 399, 407, 417, 439, 440, 441, 458, 459, 470, 479, 480, 492, 501, 504, 507, 509, 510, 513, 525, 526, 530, 534, 538, 539, 543]"
googletest,15297,1478,1331,147,"[1, 2, 3, 4, 5, 6, 7, 8, 9, 10, 11, 12, 13, 14, 15, 16, 17, 18, 19, 20, 21, 22, 23, 24, 25, 26, 27, 28, 29, 30, 31, 32, 33, 34, 35, 36, 37, 38, 39, 40, 41, 42, 43, 44, 45, 46, 47, 48, 49, 50, 51, 52, 53, 54, 55, 56, 57, 58, 59, 60, 61, 62, 63, 64, 65, 66, 67, 68, 69, 70, 71, 72, 73, 74, 75, 76, 77, 78, 79, 80, 81, 82, 83, 84, 85, 86, 87, 88, 89, 90, 91, 92, 93, 94, 95, 96, 97, 98, 99, 100]"
ruby-style-guide,15286,291,228,63,"[8, 9, 10, 11, 12, 15, 16, 21, 29, 31, 37, 40, 44, 46, 47, 48, 49, 52, 53, 54, 63, 64, 66, 68, 70, 72, 73, 74, 75, 76, 78, 79, 80, 82, 83, 84, 86, 87, 89, 96, 97, 99, 100, 103, 105, 112, 115, 117, 124, 127, 128, 132, 133, 134, 137, 138, 139, 141, 142, 143, 145, 151, 153, 156, 161, 162, 168, 169, 175, 179, 181, 184, 186, 192, 193, 194, 196, 201, 202, 204, 205, 207, 208, 211, 212, 213, 218, 219, 220, 221, 222, 223, 233, 234, 237, 238, 241, 243, 244, 250]"
chinese-independent-developer,15284,52,50,2,"[1, 2, 7, 9, 12, 16, 17, 19, 20, 21, 24, 26, 31, 32, 37, 39, 41, 45, 49, 52, 59, 62, 67, 68, 71, 72, 75, 81, 83, 84, 88, 90, 91, 92, 93, 95, 96, 106, 107, 108, 126, 131, 137, 140, 142, 143, 145, 146, 148, 151, 154, 155]"
ChromeAppHeroes,15281,36,27,9,"[1, 2, 3, 4, 5, 6, 7, 9, 10, 11, 12, 13, 14, 15, 17, 21, 23, 24, 25, 27, 28, 29, 30, 31, 32, 33, 34, 35, 36, 37, 38, 39, 40, 41, 42, 43]"
plaid,15261,330,271,59,"[1, 2, 4, 6, 7, 10, 12, 13, 14, 15, 17, 18, 19, 20, 22, 23, 24, 26, 27, 28, 29, 31, 32, 34, 36, 37, 38, 41, 44, 45, 46, 47, 48, 49, 50, 54, 55, 56, 57, 58, 59, 60, 61, 65, 66, 67, 69, 70, 72, 78, 80, 81, 84, 89, 90, 91, 92, 93, 94, 95, 96, 98, 99, 100, 102, 103, 105, 106, 107, 108, 109, 111, 112, 113, 115, 116, 117, 118, 119, 120, 121, 128, 129, 130, 131, 132, 134, 136, 139, 140, 141, 142, 146, 147, 153, 154, 155, 156, 159, 161]"
hexo-theme-next,15220,1833,1773,60,"[1, 2, 3, 5, 6, 7, 8, 12, 13, 14, 15, 17, 18, 19, 20, 21, 22, 23, 24, 25, 26, 27, 29, 30, 31, 32, 33, 34, 35, 36, 37, 39, 40, 41, 42, 44, 45, 46, 47, 48, 49, 50, 51, 52, 53, 54, 55, 56, 57, 58, 59, 60, 61, 62, 63, 64, 65, 66, 67, 68, 69, 71, 72, 73, 74, 75, 76, 77, 78, 79, 80, 81, 82, 86, 87, 88, 89, 90, 91, 92, 93, 94, 95, 96, 97, 98, 99, 100, 101, 102, 103, 105, 106, 107, 108, 109, 110, 111, 113, 114]"
SwitchyOmega,15206,1998,1632,366,"[1, 2, 3, 4, 5, 6, 7, 8, 9, 10, 11, 12, 13, 14, 15, 16, 17, 18, 19, 20, 21, 22, 23, 24, 25, 26, 27, 28, 29, 30, 31, 32, 33, 34, 35, 38, 39, 40, 41, 42, 43, 44, 46, 47, 48, 49, 50, 51, 52, 53, 54, 55, 56, 57, 58, 59, 60, 61, 62, 63, 64, 65, 66, 67, 68, 69, 70, 71, 72, 73, 74, 75, 76, 77, 78, 79, 80, 81, 82, 83, 84, 85, 86, 87, 88, 89, 90, 91, 92, 93, 94, 95, 96, 97, 98, 99, 100, 102, 103, 104]"
hosts,15199,869,838,31,"[1, 5, 6, 8, 9, 12, 13, 14, 15, 16, 17, 18, 19, 21, 22, 24, 25, 26, 27, 28, 37, 38, 39, 40, 41, 47, 49, 50, 51, 52, 56, 57, 58, 61, 62, 64, 65, 67, 68, 71, 72, 75, 77, 79, 81, 83, 84, 86, 87, 89, 90, 91, 92, 93, 95, 96, 97, 98, 101, 102, 104, 107, 108, 109, 113, 115, 116, 117, 118, 119, 121, 122, 125, 126, 127, 128, 130, 134, 135, 136, 137, 138, 139, 144, 145, 147, 148, 150, 151, 153, 154, 155, 156, 157, 158, 159, 160, 161, 162, 163]"
awesome-rust,15179,81,68,13,"[3, 8, 12, 13, 14, 18, 21, 28, 32, 51, 52, 60, 81, 87, 101, 103, 110, 117, 120, 157, 168, 183, 190, 197, 201, 230, 251, 256, 258, 266, 281, 289, 296, 309, 330, 331, 333, 337, 341, 348, 353, 371, 382, 389, 404, 414, 419, 430, 435, 460, 463, 464, 465, 479, 482, 537, 544, 552, 576, 595, 606, 627, 632, 698, 715, 717, 729, 742, 763, 783, 784, 794, 801, 814, 821, 824, 834, 859, 861, 869, 872]"
phoenix,15170,1870,1860,10,"[1, 2, 3, 4, 5, 6, 7, 9, 10, 11, 13, 15, 19, 20, 21, 25, 26, 27, 31, 33, 34, 35, 36, 37, 40, 42, 43, 44, 48, 51, 57, 58, 59, 60, 66, 70, 72, 73, 76, 77, 87, 88, 92, 93, 97, 98, 101, 102, 106, 113, 114, 115, 118, 119, 123, 124, 125, 126, 127, 128, 129, 130, 131, 134, 135, 136, 137, 148, 151, 154, 155, 156, 157, 158, 160, 163, 164, 165, 168, 169, 171, 172, 173, 175, 176, 177, 179, 180, 183, 187, 188, 189, 190, 194, 196, 201, 202, 203, 204, 206]"
bower,15146,1897,1892,5,"[2, 3, 6, 7, 8, 10, 11, 12, 14, 16, 17, 18, 19, 20, 21, 22, 23, 24, 29, 30, 31, 32, 33, 37, 38, 39, 40, 41, 42, 43, 45, 46, 47, 48, 49, 50, 51, 52, 53, 54, 55, 56, 58, 59, 60, 61, 64, 65, 66, 67, 68, 69, 70, 71, 72, 74, 75, 76, 77, 79, 80, 81, 82, 83, 86, 87, 88, 90, 91, 93, 98, 99, 101, 102, 104, 105, 106, 107, 108, 110, 111, 112, 113, 114, 116, 117, 118, 119, 120, 121, 122, 123, 125, 126, 127, 130, 131, 134, 135, 136]"
yapi,15099,1578,739,839,"[1, 2, 3, 4, 5, 6, 7, 8, 9, 10, 11, 12, 13, 14, 15, 16, 17, 18, 19, 20, 21, 22, 23, 24, 25, 26, 27, 28, 29, 30, 31, 32, 33, 34, 37, 38, 39, 40, 42, 43, 44, 45, 47, 48, 49, 50, 51, 52, 53, 54, 55, 56, 57, 58, 59, 60, 61, 62, 63, 64, 65, 66, 67, 68, 69, 70, 71, 72, 73, 74, 75, 76, 77, 78, 79, 80, 81, 82, 84, 86, 87, 88, 89, 90, 91, 92, 93, 94, 95, 96, 97, 98, 99, 100, 101, 102, 103, 104, 105, 106]"
awesome-deep-learning,15071,13,13,0,"[3, 25, 58, 60, 61, 67, 76, 78, 87, 96, 128, 143, 150]"
superagent,15070,957,837,120,"[1, 2, 3, 4, 5, 6, 7, 9, 10, 11, 12, 14, 15, 16, 17, 18, 19, 22, 26, 27, 28, 29, 30, 31, 32, 33, 34, 35, 38, 39, 40, 41, 42, 43, 44, 45, 46, 47, 48, 49, 50, 51, 54, 57, 59, 60, 61, 62, 63, 64, 65, 66, 67, 68, 69, 70, 71, 72, 73, 74, 75, 78, 80, 82, 83, 84, 85, 86, 87, 88, 89, 90, 91, 93, 94, 95, 96, 97, 99, 100, 102, 103, 108, 111, 112, 113, 114, 115, 116, 119, 120, 125, 128, 129, 130, 132, 133, 135, 136, 137]"
NeteaseCloudMusicApi,15067,669,632,37,"[1, 2, 6, 7, 8, 9, 10, 11, 13, 14, 15, 16, 17, 18, 19, 20, 21, 22, 23, 25, 26, 27, 28, 29, 30, 31, 32, 33, 34, 35, 36, 37, 39, 40, 41, 42, 43, 44, 45, 46, 47, 48, 49, 50, 51, 52, 53, 54, 55, 56, 57, 58, 59, 60, 61, 62, 63, 64, 65, 66, 67, 68, 70, 71, 72, 73, 74, 75, 76, 77, 78, 79, 80, 81, 82, 83, 84, 85, 86, 87, 88, 89, 90, 91, 92, 93, 94, 95, 96, 98, 99, 100, 101, 102, 103, 104, 105, 106, 107, 108]"
react-demos,15047,27,27,0,"[4, 5, 7, 8, 15, 16, 17, 18, 24, 25, 26, 28, 29, 30, 32, 35, 37, 39, 42, 43, 45, 46, 47, 49, 54, 55, 56]"
libuv,15040,1184,1112,72,"[4, 5, 6, 7, 10, 11, 12, 16, 18, 20, 25, 27, 28, 29, 30, 32, 34, 35, 37, 40, 42, 43, 45, 52, 53, 56, 57, 62, 64, 65, 68, 70, 71, 72, 74, 78, 79, 80, 81, 85, 87, 93, 94, 95, 96, 97, 100, 101, 102, 103, 106, 107, 108, 111, 112, 117, 120, 124, 125, 126, 128, 131, 137, 138, 139, 140, 145, 149, 152, 153, 154, 155, 157, 158, 160, 163, 169, 170, 172, 173, 174, 177, 179, 180, 181, 182, 183, 186, 188, 190, 191, 193, 195, 196, 200, 202, 203, 205, 206, 207]"
SwiftGuide,15030,27,27,0,"[1, 2, 4, 5, 6, 7, 9, 11, 14, 16, 17, 18, 19, 20, 23, 25, 29, 36, 38, 41, 60, 62, 64, 68, 69, 70, 71]"
magenta,15018,679,459,220,"[41, 46, 47, 49, 51, 56, 57, 58, 59, 62, 63, 65, 79, 81, 82, 83, 95, 99, 100, 101, 102, 104, 105, 106, 107, 110, 113, 115, 118, 120, 121, 122, 123, 125, 140, 144, 149, 150, 156, 157, 158, 159, 164, 167, 169, 172, 180, 182, 185, 188, 199, 206, 207, 208, 215, 219, 220, 221, 224, 225, 229, 237, 243, 264, 267, 274, 282, 283, 296, 300, 301, 302, 303, 304, 305, 307, 317, 320, 331, 341, 350, 354, 357, 358, 368, 372, 373, 375, 379, 384, 385, 386, 391, 401, 402, 403, 405, 429, 435, 437]"
v8,15004,0,0,0,[]
react-loadable,15000,0,0,0,[]
ice,14995,1324,1270,54,"[4, 5, 7, 10, 31, 41, 46, 47, 53, 54, 55, 56, 62, 63, 64, 65, 66, 70, 71, 72, 73, 74, 77, 78, 79, 81, 89, 92, 93, 94, 95, 97, 98, 110, 111, 112, 115, 117, 118, 119, 121, 122, 123, 124, 125, 126, 127, 128, 129, 133, 136, 138, 141, 142, 145, 148, 151, 152, 154, 155, 156, 158, 162, 163, 165, 175, 177, 178, 182, 191, 192, 193, 194, 195, 196, 197, 203, 204, 205, 206, 207, 208, 209, 211, 212, 214, 215, 216, 217, 218, 219, 221, 222, 223, 224, 225, 226, 227, 228, 229]"
statsd,14991,257,217,40,"[1, 9, 11, 12, 16, 19, 22, 28, 32, 35, 44, 49, 54, 65, 66, 88, 90, 91, 92, 95, 98, 100, 103, 110, 113, 122, 124, 129, 134, 139, 140, 141, 143, 146, 147, 149, 157, 159, 161, 164, 168, 170, 172, 175, 181, 182, 187, 188, 196, 203, 204, 210, 216, 220, 221, 230, 235, 239, 241, 245, 247, 249, 250, 252, 253, 254, 260, 275, 279, 281, 282, 283, 286, 293, 294, 298, 300, 302, 303, 306, 308, 309, 313, 315, 317, 318, 324, 326, 330, 335, 339, 341, 351, 353, 354, 357, 358, 359, 360, 362]"
fish-shell,14977,4984,4506,478,"[1, 2, 3, 4, 5, 6, 7, 8, 9, 10, 11, 12, 13, 14, 15, 16, 17, 18, 19, 20, 21, 22, 23, 24, 25, 26, 27, 28, 29, 30, 31, 32, 33, 34, 35, 36, 38, 39, 40, 41, 42, 43, 44, 45, 46, 47, 48, 49, 50, 51, 52, 53, 54, 55, 56, 57, 59, 60, 61, 62, 63, 64, 65, 66, 67, 69, 70, 71, 72, 73, 74, 75, 76, 77, 78, 79, 80, 81, 82, 83, 84, 85, 86, 87, 88, 89, 90, 91, 93, 94, 95, 96, 97, 98, 99, 100, 101, 102, 103, 105]"
tinker,14972,1277,994,283,"[1, 3, 4, 5, 7, 8, 9, 10, 11, 12, 13, 14, 16, 17, 18, 19, 20, 21, 22, 23, 24, 25, 26, 27, 29, 30, 31, 32, 33, 34, 35, 36, 37, 38, 39, 40, 41, 42, 43, 44, 45, 46, 47, 48, 49, 50, 51, 52, 53, 54, 55, 57, 58, 60, 61, 62, 63, 64, 65, 66, 67, 68, 69, 70, 71, 72, 73, 74, 75, 78, 79, 80, 81, 82, 84, 85, 88, 89, 90, 91, 92, 93, 94, 95, 96, 97, 98, 99, 101, 102, 103, 104, 106, 107, 109, 110, 111, 112, 113, 114]"
folly,14966,672,494,178,"[4, 5, 6, 7, 8, 12, 14, 16, 18, 23, 24, 25, 31, 32, 33, 34, 35, 41, 42, 45, 46, 48, 50, 51, 52, 54, 59, 60, 62, 63, 66, 70, 71, 72, 73, 74, 75, 76, 77, 78, 85, 86, 87, 89, 90, 92, 93, 94, 96, 98, 99, 100, 101, 103, 104, 106, 107, 108, 115, 116, 117, 118, 119, 121, 123, 124, 128, 129, 133, 134, 141, 143, 147, 170, 182, 183, 191, 198, 203, 204, 205, 208, 213, 217, 219, 221, 228, 229, 231, 232, 233, 234, 236, 237, 239, 240, 241, 242, 243, 286]"
trix,14966,596,556,40,"[8, 9, 10, 11, 12, 13, 16, 28, 29, 30, 31, 33, 35, 36, 37, 38, 39, 40, 41, 42, 44, 45, 46, 47, 48, 49, 50, 52, 53, 54, 55, 57, 58, 60, 61, 62, 63, 64, 67, 68, 70, 71, 72, 73, 74, 75, 76, 77, 78, 79, 80, 81, 82, 84, 85, 86, 87, 89, 91, 92, 93, 96, 97, 98, 100, 101, 102, 103, 104, 105, 106, 109, 110, 111, 114, 115, 117, 118, 119, 120, 121, 122, 123, 124, 125, 126, 127, 128, 129, 130, 132, 133, 135, 136, 137, 138, 139, 140, 141, 142]"
lazydocker,14962,129,72,57,"[2, 4, 5, 6, 7, 9, 11, 12, 13, 15, 16, 20, 22, 23, 24, 25, 26, 27, 28, 29, 30, 31, 33, 34, 35, 40, 41, 42, 44, 47, 48, 49, 51, 52, 53, 56, 57, 58, 61, 63, 64, 66, 67, 68, 70, 71, 72, 73, 76, 78, 80, 82, 83, 87, 89, 91, 94, 95, 100, 101, 104, 105, 106, 109, 110, 113, 115, 119, 121, 122, 123, 125, 126, 134, 135, 137, 139, 140, 141, 143, 144, 146, 147, 151, 152, 153, 154, 157, 158, 160, 161, 165, 166, 167, 168, 169, 170, 173, 174, 175]"
hiring-without-whiteboards,14935,0,0,0,[]
dropzone,14932,0,0,0,[]
algo,14929,100,17,83,"[18, 24, 26, 28, 30, 34, 37, 42, 49, 59, 60, 67, 82, 83, 84, 92, 114, 119, 124, 126, 133, 138, 153, 156, 159, 161, 179, 183, 203, 204, 216, 228, 231, 232, 234, 237, 244, 248, 251, 254, 260, 262, 269, 272, 279, 285, 288, 290, 291, 296, 302, 316, 317, 324, 341, 343, 353, 355, 365, 368, 372, 380, 394, 398, 399, 400, 406, 409, 410, 413, 420, 423, 425, 426, 429, 430, 431, 432, 433, 436, 437, 439, 440, 441, 443, 444, 447, 449, 450, 453, 454, 455, 457, 460, 461, 463, 464, 466, 467, 468]"
openpilot,14922,431,395,36,"[1, 3, 4, 5, 6, 7, 9, 10, 11, 12, 14, 16, 17, 18, 19, 20, 21, 22, 23, 24, 25, 26, 27, 28, 29, 30, 31, 32, 33, 34, 35, 41, 42, 44, 45, 46, 48, 50, 51, 52, 53, 54, 55, 56, 57, 58, 59, 60, 61, 62, 63, 64, 66, 67, 68, 69, 70, 71, 72, 73, 74, 75, 77, 78, 79, 80, 81, 83, 84, 86, 87, 88, 89, 91, 92, 96, 97, 98, 99, 100, 105, 106, 107, 110, 111, 112, 115, 122, 124, 127, 128, 130, 131, 132, 133, 134, 135, 136, 142, 144]"
halo,14902,557,498,59,"[3, 4, 6, 7, 9, 10, 11, 12, 13, 14, 15, 16, 17, 19, 20, 22, 23, 25, 26, 27, 28, 29, 30, 31, 32, 34, 35, 36, 39, 40, 42, 43, 44, 45, 46, 47, 48, 49, 50, 51, 52, 53, 54, 55, 58, 59, 60, 61, 62, 63, 64, 65, 66, 67, 68, 70, 71, 72, 74, 75, 76, 77, 79, 80, 81, 82, 83, 84, 85, 86, 90, 91, 92, 93, 94, 95, 96, 97, 99, 100, 101, 102, 103, 104, 105, 106, 107, 108, 109, 110, 111, 112, 113, 114, 115, 116, 117, 118, 121, 122]"
celery,14902,4104,3717,387,"[1, 2, 3, 4, 5, 6, 7, 8, 9, 10, 11, 12, 13, 14, 15, 16, 17, 18, 19, 20, 21, 22, 23, 24, 25, 26, 27, 28, 29, 30, 31, 32, 33, 34, 35, 36, 37, 38, 39, 40, 41, 42, 43, 44, 45, 46, 47, 48, 49, 50, 51, 52, 53, 54, 55, 56, 57, 58, 59, 60, 61, 62, 63, 64, 65, 66, 67, 68, 69, 70, 71, 72, 73, 74, 75, 76, 77, 78, 79, 80, 81, 82, 83, 84, 85, 86, 87, 88, 89, 90, 91, 92, 93, 94, 95, 96, 97, 98, 99, 100]"
PHPMailer,14896,1564,1513,51,"[5, 6, 7, 9, 10, 11, 12, 14, 15, 16, 19, 20, 21, 22, 24, 25, 28, 29, 32, 33, 34, 35, 36, 37, 39, 40, 41, 42, 43, 45, 47, 48, 49, 50, 51, 52, 53, 54, 55, 56, 57, 59, 60, 62, 64, 65, 67, 69, 72, 73, 74, 75, 76, 77, 78, 79, 81, 82, 83, 84, 85, 86, 87, 88, 89, 91, 92, 93, 95, 96, 97, 98, 100, 102, 103, 104, 105, 106, 107, 108, 111, 113, 114, 115, 117, 118, 119, 120, 121, 123, 125, 127, 128, 129, 131, 133, 137, 138, 139, 142]"
AR.js,14886,624,619,5,"[1, 2, 3, 4, 5, 7, 11, 12, 13, 14, 15, 16, 17, 18, 19, 20, 21, 22, 23, 24, 25, 26, 27, 28, 30, 31, 34, 35, 36, 37, 38, 39, 40, 41, 42, 43, 44, 45, 46, 47, 48, 49, 50, 51, 52, 53, 54, 55, 56, 57, 58, 60, 61, 62, 63, 65, 67, 68, 69, 70, 71, 73, 74, 76, 77, 78, 79, 80, 81, 82, 83, 84, 85, 86, 87, 88, 89, 90, 91, 92, 94, 95, 96, 97, 98, 99, 100, 101, 102, 103, 104, 106, 107, 108, 109, 110, 111, 112, 113, 114]"
go,14873,45,22,23,"[7, 8, 13, 17, 21, 23, 26, 35, 43, 52, 54, 58, 61, 70, 81, 83, 84, 88, 90, 94, 97, 98, 99, 100, 102, 108, 111, 114, 121, 132, 133, 134, 135, 136, 142, 143, 144, 145, 160, 161, 164, 166, 174, 175, 176]"
keystone-classic,14849,2447,2150,297,"[1, 2, 3, 4, 5, 6, 7, 8, 9, 10, 11, 12, 13, 14, 15, 16, 17, 18, 19, 20, 21, 22, 23, 24, 25, 26, 27, 28, 29, 30, 31, 32, 33, 34, 35, 36, 37, 38, 39, 40, 41, 42, 43, 44, 45, 46, 47, 48, 49, 50, 51, 52, 54, 56, 57, 58, 59, 60, 61, 62, 64, 65, 66, 67, 68, 69, 70, 71, 74, 75, 78, 79, 81, 83, 84, 86, 87, 88, 89, 93, 94, 95, 96, 97, 98, 100, 101, 102, 105, 106, 107, 108, 110, 111, 114, 115, 116, 117, 118, 119]"
notable,14848,1050,746,304,"[1, 2, 3, 4, 5, 6, 7, 9, 11, 12, 13, 14, 15, 17, 18, 19, 20, 21, 22, 23, 24, 25, 26, 27, 28, 29, 30, 31, 32, 33, 35, 36, 37, 38, 39, 40, 41, 42, 44, 45, 46, 47, 48, 49, 50, 51, 52, 53, 54, 55, 56, 58, 59, 60, 64, 65, 66, 67, 68, 69, 70, 71, 72, 73, 74, 75, 76, 77, 78, 79, 81, 82, 83, 84, 85, 86, 87, 88, 89, 90, 91, 92, 93, 94, 95, 96, 97, 98, 99, 100, 101, 102, 103, 104, 105, 106, 107, 108, 109, 110]"
pace,14842,418,139,279,"[2, 3, 4, 5, 8, 9, 10, 11, 12, 13, 14, 19, 20, 22, 23, 24, 25, 26, 27, 28, 29, 30, 32, 33, 34, 36, 37, 39, 40, 41, 44, 46, 47, 48, 49, 50, 52, 54, 55, 56, 57, 59, 60, 61, 62, 63, 64, 65, 66, 67, 68, 70, 71, 72, 73, 74, 75, 76, 77, 78, 79, 80, 82, 83, 84, 85, 86, 87, 88, 89, 90, 92, 93, 94, 98, 99, 101, 102, 103, 106, 107, 108, 109, 110, 111, 113, 114, 115, 116, 117, 118, 120, 121, 122, 123, 124, 125, 126, 127, 128]"
popper-core,14819,612,611,1,"[1, 2, 3, 6, 8, 9, 12, 18, 19, 20, 21, 22, 23, 24, 25, 26, 27, 29, 30, 32, 33, 34, 36, 38, 39, 40, 41, 42, 44, 45, 46, 48, 49, 50, 51, 52, 54, 55, 56, 58, 59, 60, 61, 62, 63, 65, 67, 70, 71, 72, 75, 76, 78, 79, 80, 81, 83, 84, 85, 86, 90, 93, 94, 95, 98, 99, 100, 101, 102, 106, 107, 111, 112, 113, 114, 115, 116, 117, 118, 119, 120, 123, 125, 126, 127, 128, 129, 130, 136, 138, 139, 140, 143, 144, 149, 150, 151, 162, 163, 167]"
q,14812,547,447,100,"[2, 3, 5, 9, 11, 12, 13, 17, 20, 22, 23, 24, 26, 27, 28, 29, 30, 31, 32, 34, 35, 36, 39, 42, 43, 44, 48, 50, 51, 52, 53, 54, 55, 56, 57, 58, 60, 62, 63, 64, 65, 67, 68, 69, 70, 72, 74, 75, 77, 78, 79, 85, 86, 87, 88, 89, 92, 96, 97, 98, 100, 102, 103, 104, 106, 107, 108, 109, 111, 112, 113, 115, 116, 117, 118, 119, 120, 122, 127, 128, 129, 131, 134, 135, 136, 137, 138, 139, 141, 142, 144, 146, 148, 151, 152, 153, 154, 157, 158, 159]"
project-layout,14811,42,9,33,"[1, 3, 4, 5, 7, 8, 9, 10, 11, 12, 13, 14, 18, 19, 22, 23, 24, 25, 26, 28, 30, 32, 34, 36, 37, 38, 39, 41, 43, 44, 45, 47, 48, 50, 51, 52, 53, 54, 55, 61, 62, 63]"
awesome-blockchain-cn,14804,25,18,7,"[1, 2, 3, 4, 7, 8, 9, 10, 11, 15, 18, 21, 22, 24, 26, 27, 28, 31, 32, 36, 38, 40, 45, 47, 48]"
Public-APIs,14798,35,31,4,"[10, 11, 15, 16, 17, 18, 19, 22, 24, 26, 34, 38, 47, 51, 62, 75, 77, 98, 110, 111, 118, 134, 148, 154, 165, 189, 263, 290, 314, 318, 325, 327, 330, 338, 339]"
quick-look-plugins,14786,78,72,6,"[3, 4, 5, 6, 7, 8, 9, 10, 11, 12, 13, 15, 16, 18, 19, 20, 21, 23, 25, 26, 27, 28, 29, 30, 31, 34, 38, 39, 40, 41, 42, 43, 44, 48, 49, 55, 57, 59, 60, 61, 63, 67, 68, 69, 70, 71, 72, 73, 74, 75, 76, 77, 78, 81, 83, 84, 85, 86, 87, 89, 90, 91, 92, 94, 97, 100, 102, 103, 104, 109, 110, 112, 113, 114, 115, 116, 117, 120]"
jasmine,14784,1251,1192,59,"[1, 2, 3, 4, 5, 6, 7, 8, 9, 10, 11, 12, 13, 15, 16, 17, 19, 20, 21, 22, 24, 27, 28, 30, 31, 32, 33, 35, 36, 37, 40, 45, 47, 48, 49, 50, 51, 52, 53, 58, 59, 60, 61, 65, 77, 79, 80, 84, 85, 86, 87, 88, 89, 91, 92, 94, 95, 97, 99, 103, 105, 106, 107, 108, 109, 110, 113, 114, 115, 116, 118, 119, 121, 122, 124, 125, 126, 127, 128, 129, 130, 131, 132, 133, 134, 139, 140, 141, 143, 144, 145, 147, 150, 151, 153, 154, 155, 160, 161, 162]"
joi,14758,1816,1796,20,"[15, 16, 19, 20, 23, 25, 38, 46, 56, 59, 60, 63, 66, 67, 78, 79, 82, 83, 86, 88, 89, 92, 93, 95, 97, 98, 101, 106, 107, 112, 115, 116, 117, 121, 122, 124, 125, 126, 127, 128, 130, 133, 135, 140, 141, 142, 143, 146, 149, 150, 154, 155, 156, 158, 161, 162, 165, 166, 167, 168, 170, 173, 175, 177, 178, 179, 181, 184, 185, 187, 188, 189, 190, 192, 193, 194, 195, 196, 197, 198, 199, 200, 202, 203, 204, 207, 211, 213, 214, 215, 216, 217, 220, 221, 222, 223, 225, 227, 228, 229]"
crystal,14748,5066,4197,869,"[1, 2, 3, 4, 5, 6, 7, 8, 9, 10, 11, 12, 14, 15, 16, 17, 18, 19, 22, 23, 24, 25, 26, 27, 28, 30, 31, 32, 33, 34, 41, 42, 45, 46, 47, 48, 49, 50, 52, 54, 55, 57, 58, 59, 60, 61, 64, 65, 66, 67, 68, 69, 75, 76, 78, 79, 82, 89, 91, 92, 93, 94, 95, 96, 97, 98, 102, 104, 105, 107, 111, 115, 116, 117, 118, 119, 120, 122, 123, 124, 125, 127, 129, 130, 131, 132, 134, 137, 138, 140, 143, 144, 145, 146, 147, 149, 150, 153, 154, 155]"
zepto,14743,746,678,68,"[13, 18, 19, 20, 22, 30, 31, 32, 34, 35, 38, 39, 40, 41, 43, 44, 50, 52, 54, 56, 63, 67, 68, 69, 72, 73, 74, 80, 84, 85, 86, 87, 88, 89, 90, 91, 93, 94, 103, 109, 110, 111, 112, 118, 119, 120, 121, 125, 128, 129, 131, 135, 136, 139, 140, 142, 143, 146, 147, 148, 150, 155, 156, 164, 170, 171, 172, 173, 174, 176, 177, 180, 185, 187, 195, 197, 198, 199, 200, 203, 206, 209, 210, 211, 212, 213, 215, 216, 217, 218, 220, 223, 228, 229, 232, 233, 235, 236, 237, 242]"
logrus,14736,515,435,80,"[5, 8, 13, 15, 20, 24, 25, 28, 29, 30, 31, 38, 39, 41, 42, 43, 44, 47, 52, 54, 56, 57, 63, 64, 66, 67, 72, 77, 78, 80, 81, 82, 88, 94, 98, 99, 102, 107, 108, 109, 110, 112, 113, 114, 116, 118, 120, 121, 125, 135, 136, 137, 141, 142, 144, 150, 151, 153, 156, 159, 161, 163, 164, 165, 166, 167, 172, 173, 174, 175, 176, 181, 182, 184, 185, 196, 197, 202, 205, 207, 211, 216, 217, 220, 221, 222, 223, 227, 229, 230, 232, 234, 236, 240, 241, 243, 250, 252, 253, 255]"
ToolsOfTheTrade,14714,37,36,1,"[14, 20, 25, 27, 76, 85, 87, 109, 118, 120, 121, 151, 170, 180, 190, 191, 255, 267, 275, 278, 301, 312, 332, 335, 338, 360, 364, 380, 381, 382, 385, 400, 401, 404, 406, 451, 461]"
Flat-UI,14708,188,179,9,"[1, 3, 4, 5, 7, 8, 9, 11, 12, 13, 14, 15, 18, 19, 20, 21, 22, 23, 25, 26, 27, 28, 29, 31, 32, 33, 36, 37, 39, 40, 41, 43, 44, 45, 46, 47, 49, 50, 51, 52, 53, 54, 55, 56, 57, 58, 59, 60, 61, 62, 63, 64, 65, 66, 67, 68, 70, 71, 74, 75, 76, 79, 80, 81, 83, 84, 85, 89, 93, 94, 97, 98, 99, 101, 102, 103, 104, 105, 106, 107, 108, 109, 111, 112, 113, 115, 116, 117, 118, 119, 120, 121, 122, 124, 126, 127, 128, 130, 131, 132]"
dva,14688,2033,1996,37,"[1, 2, 3, 4, 6, 7, 8, 11, 15, 16, 19, 20, 21, 22, 23, 24, 26, 29, 36, 39, 40, 41, 43, 44, 45, 46, 48, 49, 50, 51, 52, 53, 54, 55, 58, 60, 61, 62, 63, 64, 65, 66, 67, 68, 70, 72, 73, 74, 75, 76, 77, 78, 79, 80, 81, 82, 83, 84, 85, 87, 88, 89, 91, 92, 93, 95, 96, 97, 98, 99, 100, 101, 102, 103, 104, 106, 107, 108, 109, 110, 111, 112, 113, 114, 115, 116, 117, 118, 119, 120, 121, 122, 123, 124, 125, 126, 127, 128, 129, 130]"
bootstrap,14650,4455,4185,270,"[3, 5, 8, 9, 10, 11, 12, 13, 16, 17, 20, 24, 26, 28, 32, 34, 37, 41, 42, 43, 44, 45, 46, 47, 50, 51, 53, 55, 56, 59, 61, 62, 64, 68, 69, 73, 75, 78, 79, 81, 82, 85, 86, 89, 90, 91, 93, 94, 95, 96, 98, 99, 100, 101, 102, 103, 105, 108, 110, 111, 114, 115, 120, 121, 122, 123, 124, 126, 128, 129, 130, 131, 132, 133, 134, 135, 137, 138, 139, 140, 142, 144, 145, 146, 155, 156, 157, 158, 160, 163, 164, 165, 166, 170, 171, 175, 176, 178, 179, 180]"
NES.css,14627,151,130,21,"[1, 2, 3, 5, 6, 7, 8, 9, 13, 18, 19, 21, 22, 25, 27, 28, 33, 34, 35, 37, 38, 39, 42, 51, 53, 57, 58, 59, 60, 62, 65, 70, 72, 73, 74, 77, 79, 81, 83, 85, 86, 91, 93, 95, 97, 99, 101, 102, 104, 107, 113, 124, 137, 139, 146, 148, 152, 153, 158, 166, 169, 173, 175, 178, 179, 180, 184, 185, 193, 194, 195, 196, 197, 200, 205, 206, 207, 211, 214, 218, 219, 220, 222, 223, 226, 227, 228, 230, 232, 235, 238, 240, 241, 242, 244, 246, 248, 249, 250, 253]"
masonry,14616,1074,1043,31,"[1, 2, 3, 4, 5, 6, 7, 8, 9, 10, 11, 12, 13, 14, 15, 16, 17, 18, 19, 20, 21, 22, 23, 24, 25, 27, 28, 29, 30, 32, 33, 34, 35, 36, 37, 38, 39, 40, 42, 43, 44, 45, 46, 47, 48, 49, 50, 51, 52, 53, 54, 55, 56, 57, 58, 59, 60, 61, 62, 63, 64, 65, 66, 67, 68, 69, 70, 71, 72, 73, 74, 75, 76, 77, 78, 79, 80, 81, 82, 83, 84, 86, 87, 88, 90, 91, 92, 93, 94, 95, 96, 97, 98, 99, 100, 101, 102, 103, 104, 105]"
bazel,14607,7620,5433,2187,"[9, 10, 11, 12, 14, 15, 16, 17, 18, 21, 22, 23, 25, 26, 27, 29, 30, 31, 32, 34, 38, 39, 41, 42, 43, 46, 47, 49, 50, 51, 52, 53, 54, 55, 56, 57, 58, 59, 61, 63, 64, 65, 66, 67, 68, 69, 70, 71, 72, 73, 74, 75, 77, 78, 79, 82, 85, 86, 87, 88, 89, 90, 91, 92, 94, 95, 97, 98, 99, 101, 102, 103, 105, 107, 109, 111, 112, 113, 114, 115, 116, 117, 118, 119, 120, 121, 122, 124, 125, 126, 127, 128, 129, 130, 131, 132, 133, 134, 135, 136]"
cs-video-courses,14600,21,18,3,"[9, 16, 18, 25, 26, 27, 28, 29, 31, 32, 38, 47, 49, 52, 53, 55, 59, 65, 67, 73, 99]"
parallax,14593,244,200,44,"[1, 2, 3, 4, 5, 6, 7, 9, 11, 12, 13, 15, 16, 17, 18, 19, 20, 21, 22, 23, 24, 25, 26, 27, 28, 29, 30, 31, 32, 33, 34, 35, 36, 37, 38, 39, 40, 41, 42, 43, 44, 45, 46, 47, 48, 50, 51, 52, 53, 54, 55, 56, 57, 58, 59, 60, 61, 62, 65, 66, 67, 68, 69, 71, 72, 73, 74, 75, 76, 77, 78, 79, 80, 81, 82, 83, 84, 85, 86, 87, 88, 89, 91, 93, 94, 95, 99, 100, 103, 104, 105, 106, 108, 109, 110, 111, 112, 113, 114, 115]"
websocketd,14584,275,250,25,"[4, 5, 6, 7, 8, 9, 11, 14, 17, 18, 19, 20, 25, 26, 27, 28, 29, 30, 32, 34, 35, 36, 37, 38, 40, 44, 45, 46, 49, 50, 51, 53, 55, 57, 58, 60, 62, 63, 66, 67, 69, 70, 71, 72, 75, 76, 77, 78, 79, 80, 81, 83, 84, 85, 87, 88, 93, 94, 95, 96, 97, 98, 99, 101, 102, 105, 107, 109, 112, 117, 121, 122, 123, 124, 127, 129, 130, 131, 132, 133, 134, 135, 136, 137, 138, 139, 141, 142, 143, 144, 146, 147, 148, 149, 151, 153, 155, 156, 157, 159]"
electron-react-boilerplate,14577,1158,1119,39,"[1, 4, 5, 8, 10, 12, 15, 16, 17, 19, 20, 23, 24, 28, 29, 30, 31, 32, 33, 36, 37, 39, 40, 42, 43, 44, 45, 47, 49, 51, 55, 57, 60, 62, 64, 67, 73, 75, 80, 81, 82, 88, 90, 94, 103, 108, 109, 112, 115, 118, 119, 120, 123, 125, 127, 128, 129, 130, 132, 137, 138, 139, 140, 141, 144, 148, 149, 151, 152, 153, 156, 157, 159, 160, 163, 168, 169, 172, 175, 176, 177, 178, 180, 181, 182, 187, 193, 194, 196, 198, 199, 202, 204, 205, 207, 208, 209, 210, 211, 213]"
API-Security-Checklist,14564,29,19,10,"[2, 6, 7, 8, 10, 11, 13, 15, 19, 20, 23, 25, 26, 27, 32, 33, 34, 47, 49, 59, 77, 79, 104, 113, 119, 120, 122, 127, 140]"
quasar,14553,4340,4150,190,"[1, 2, 3, 4, 5, 6, 7, 8, 9, 10, 11, 12, 13, 14, 15, 16, 17, 18, 19, 20, 21, 22, 23, 24, 25, 26, 27, 28, 29, 30, 31, 32, 33, 34, 35, 36, 37, 38, 39, 40, 41, 42, 43, 44, 45, 46, 47, 48, 49, 50, 51, 52, 53, 54, 55, 56, 57, 58, 59, 60, 61, 62, 63, 64, 65, 66, 69, 70, 71, 72, 73, 74, 75, 76, 77, 78, 79, 80, 81, 82, 83, 84, 85, 86, 87, 88, 89, 90, 91, 92, 93, 95, 96, 97, 98, 99, 100, 101, 102, 104]"
lectures,14551,16,6,10,"[2, 6, 8, 9, 10, 11, 12, 13, 14, 15, 17, 18, 19, 20, 21, 22]"
redux-thunk,14546,182,180,2,"[1, 2, 3, 7, 9, 10, 12, 14, 15, 17, 18, 21, 25, 26, 27, 28, 29, 30, 31, 32, 33, 34, 35, 38, 42, 43, 45, 47, 48, 49, 51, 52, 56, 58, 61, 62, 63, 65, 66, 67, 69, 71, 72, 74, 75, 76, 78, 80, 81, 82, 86, 87, 88, 89, 90, 91, 92, 94, 95, 96, 97, 98, 99, 100, 102, 103, 104, 107, 108, 109, 110, 111, 112, 114, 115, 116, 118, 119, 120, 121, 122, 123, 125, 126, 129, 131, 132, 133, 134, 135, 136, 137, 139, 140, 141, 143, 144, 146, 147, 152]"
iview-admin,14544,1156,605,551,"[1, 2, 3, 4, 5, 6, 7, 8, 9, 10, 11, 12, 13, 14, 15, 16, 17, 18, 19, 20, 21, 22, 23, 24, 25, 26, 27, 28, 29, 30, 31, 32, 33, 34, 35, 36, 37, 39, 40, 41, 42, 43, 44, 45, 46, 47, 48, 49, 50, 51, 52, 53, 54, 55, 56, 57, 58, 59, 60, 61, 62, 63, 64, 65, 66, 67, 68, 69, 70, 71, 72, 73, 74, 75, 76, 77, 78, 79, 80, 81, 82, 83, 84, 85, 86, 87, 88, 89, 90, 91, 92, 93, 94, 95, 96, 97, 98, 101, 102, 103]"
MS-DOS,14521,52,49,3,"[2, 3, 5, 7, 8, 10, 11, 12, 13, 15, 16, 18, 20, 21, 22, 23, 25, 26, 28, 33, 44, 48, 49, 53, 74, 108, 170, 174, 201, 202, 253, 261, 262, 267, 283, 301, 327, 370, 385, 386, 395, 398, 401, 402, 406, 413, 414, 416, 418, 419, 423, 424]"
pwc,14519,19,4,15,"[1, 10, 11, 13, 14, 15, 16, 18, 21, 23, 24, 27, 29, 30, 31, 32, 33, 36, 38]"
Mock,14516,371,131,240,"[1, 2, 3, 5, 6, 7, 8, 9, 10, 11, 13, 14, 15, 17, 20, 21, 22, 23, 24, 25, 26, 27, 28, 29, 30, 31, 32, 33, 34, 35, 36, 37, 38, 39, 41, 42, 45, 48, 49, 50, 51, 52, 55, 56, 57, 58, 59, 60, 61, 62, 63, 64, 65, 66, 67, 68, 69, 70, 71, 72, 73, 74, 75, 76, 77, 78, 79, 80, 81, 82, 83, 84, 85, 86, 87, 88, 89, 90, 91, 92, 94, 95, 96, 97, 98, 99, 100, 101, 102, 103, 104, 105, 106, 107, 108, 109, 110, 111, 113, 114]"
portainer,14514,2555,1969,586,"[3, 4, 5, 6, 7, 10, 14, 15, 17, 20, 21, 23, 27, 31, 32, 33, 34, 35, 38, 40, 41, 42, 48, 51, 52, 54, 55, 56, 57, 58, 59, 60, 61, 62, 66, 68, 69, 70, 71, 72, 73, 74, 80, 81, 82, 84, 85, 87, 91, 93, 95, 96, 99, 101, 103, 105, 106, 107, 108, 109, 110, 111, 113, 121, 122, 123, 124, 125, 140, 142, 143, 144, 146, 147, 148, 151, 152, 153, 156, 158, 159, 160, 166, 167, 168, 169, 170, 171, 173, 175, 176, 177, 182, 183, 185, 186, 192, 193, 194, 195]"
recompose,14489,427,373,54,"[4, 5, 6, 7, 8, 9, 17, 18, 20, 21, 23, 25, 29, 34, 38, 48, 51, 54, 55, 60, 61, 63, 66, 68, 72, 73, 75, 76, 77, 80, 83, 85, 88, 90, 93, 97, 98, 101, 102, 103, 105, 106, 107, 108, 109, 112, 115, 117, 121, 122, 124, 127, 130, 131, 135, 139, 144, 146, 150, 152, 153, 156, 158, 164, 166, 168, 169, 170, 171, 176, 178, 183, 188, 190, 191, 193, 194, 197, 199, 201, 202, 203, 213, 214, 215, 216, 217, 218, 219, 220, 226, 229, 230, 231, 232, 235, 237, 239, 242, 243]"
api-guidelines,14477,77,53,24,"[6, 7, 8, 9, 10, 12, 13, 14, 15, 17, 18, 21, 22, 23, 25, 27, 28, 38, 47, 50, 51, 52, 54, 57, 58, 60, 62, 66, 67, 68, 69, 70, 71, 76, 77, 78, 79, 80, 87, 88, 89, 90, 91, 95, 96, 97, 99, 100, 102, 103, 104, 105, 106, 107, 108, 109, 110, 111, 115, 167, 168, 171, 173, 175, 176, 177, 178, 179, 181, 182, 183, 184, 185, 186, 189, 190, 194]"
ionicons,14459,705,390,315,"[1, 2, 3, 4, 5, 6, 7, 8, 11, 12, 13, 14, 17, 18, 19, 20, 21, 22, 24, 25, 26, 27, 28, 29, 30, 31, 32, 33, 34, 38, 39, 40, 41, 42, 43, 44, 45, 47, 48, 49, 50, 51, 52, 53, 54, 55, 56, 57, 58, 59, 60, 61, 62, 63, 64, 65, 66, 67, 68, 69, 70, 71, 72, 74, 75, 76, 77, 78, 80, 81, 82, 83, 84, 85, 86, 87, 88, 91, 92, 93, 94, 96, 97, 98, 99, 100, 101, 102, 103, 104, 105, 106, 107, 108, 109, 110, 111, 112, 113, 114]"
N-blog,14444,434,419,15,"[1, 2, 3, 4, 5, 6, 7, 8, 9, 10, 11, 12, 13, 14, 15, 16, 17, 18, 19, 20, 21, 22, 23, 24, 25, 26, 27, 28, 29, 30, 31, 32, 33, 35, 36, 37, 38, 39, 40, 42, 43, 44, 45, 46, 48, 49, 50, 51, 52, 53, 54, 55, 56, 57, 58, 59, 60, 62, 63, 64, 65, 66, 67, 68, 69, 70, 72, 73, 74, 75, 76, 77, 78, 79, 80, 81, 82, 83, 84, 85, 86, 87, 88, 89, 90, 91, 92, 93, 94, 95, 96, 97, 98, 99, 100, 101, 102, 103, 104, 105]"
vegeta,14440,321,287,34,"[1, 2, 3, 5, 6, 10, 12, 13, 15, 16, 25, 28, 29, 33, 38, 39, 45, 47, 51, 53, 56, 57, 58, 59, 60, 62, 63, 64, 65, 66, 67, 68, 69, 76, 80, 81, 82, 83, 85, 86, 88, 89, 94, 102, 103, 104, 105, 106, 107, 108, 110, 112, 113, 115, 117, 119, 120, 122, 123, 124, 126, 128, 129, 131, 132, 134, 135, 137, 138, 140, 141, 142, 143, 144, 145, 146, 149, 150, 151, 152, 153, 158, 159, 161, 162, 163, 164, 165, 166, 167, 168, 169, 170, 172, 173, 175, 178, 179, 180, 181]"
medium-editor,14438,898,600,298,"[1, 2, 3, 4, 5, 6, 7, 9, 10, 11, 12, 13, 14, 15, 16, 17, 19, 20, 23, 24, 25, 26, 27, 29, 30, 33, 34, 36, 38, 39, 40, 41, 42, 44, 45, 47, 48, 49, 50, 51, 52, 53, 54, 57, 64, 65, 66, 69, 70, 71, 77, 81, 83, 84, 87, 88, 91, 92, 95, 96, 101, 103, 107, 111, 113, 114, 118, 119, 121, 122, 123, 124, 125, 126, 127, 129, 130, 132, 134, 135, 136, 137, 138, 139, 140, 142, 143, 145, 146, 149, 150, 151, 158, 159, 161, 162, 164, 165, 167, 170]"
css-protips,14432,43,39,4,"[1, 2, 3, 5, 7, 8, 9, 12, 14, 16, 17, 18, 19, 20, 21, 22, 24, 30, 31, 32, 33, 34, 36, 37, 44, 45, 46, 50, 58, 59, 63, 64, 65, 67, 70, 80, 84, 95, 98, 105, 107, 110, 118]"
chalk,14417,262,252,10,"[1, 2, 3, 4, 6, 8, 9, 10, 11, 12, 13, 15, 16, 17, 20, 21, 22, 23, 24, 29, 30, 31, 32, 34, 35, 36, 38, 39, 40, 41, 42, 44, 45, 46, 47, 48, 49, 50, 51, 52, 57, 58, 59, 61, 62, 63, 65, 69, 70, 71, 73, 75, 76, 77, 78, 79, 80, 83, 84, 87, 89, 90, 94, 98, 99, 100, 102, 103, 105, 106, 107, 108, 109, 110, 111, 112, 113, 114, 115, 117, 118, 119, 121, 123, 124, 125, 126, 127, 128, 130, 131, 132, 133, 134, 135, 137, 138, 139, 141, 143]"
PayloadsAllTheThings,14412,41,35,6,"[4, 5, 9, 11, 12, 14, 16, 31, 33, 51, 59, 68, 69, 74, 77, 78, 80, 81, 84, 89, 90, 91, 95, 104, 126, 133, 140, 141, 144, 147, 153, 160, 168, 170, 177, 184, 185, 189, 194, 195, 199]"
ratchet,14406,536,334,202,"[1, 2, 3, 4, 5, 6, 7, 8, 9, 10, 11, 12, 13, 14, 15, 16, 17, 18, 19, 20, 21, 22, 23, 24, 25, 26, 27, 28, 29, 30, 31, 32, 33, 34, 35, 36, 37, 38, 39, 40, 41, 42, 43, 44, 45, 46, 47, 48, 49, 50, 51, 52, 53, 54, 55, 56, 57, 58, 59, 60, 61, 62, 63, 64, 65, 66, 67, 68, 69, 70, 71, 72, 73, 74, 75, 76, 77, 78, 79, 80, 81, 82, 83, 84, 85, 86, 87, 88, 90, 92, 96, 98, 100, 101, 102, 103, 104, 105, 106, 108]"
relay,14386,1571,1382,189,"[6, 7, 8, 10, 13, 15, 19, 20, 26, 28, 30, 32, 35, 36, 40, 42, 48, 51, 53, 55, 56, 57, 59, 61, 63, 65, 66, 68, 71, 72, 73, 75, 77, 81, 84, 86, 87, 88, 89, 91, 94, 95, 97, 99, 100, 102, 104, 105, 106, 107, 108, 110, 112, 114, 118, 119, 120, 121, 124, 125, 126, 127, 129, 130, 132, 133, 134, 135, 136, 138, 140, 141, 143, 145, 147, 148, 149, 153, 154, 156, 158, 159, 161, 162, 164, 165, 166, 168, 170, 171, 180, 182, 191, 192, 193, 194, 195, 199, 203, 205]"
spf13-vim,14377,720,408,312,"[1, 2, 3, 4, 5, 6, 8, 9, 10, 11, 12, 13, 14, 15, 16, 17, 18, 19, 23, 24, 25, 27, 29, 30, 31, 32, 34, 35, 36, 37, 40, 41, 42, 43, 46, 47, 48, 53, 54, 55, 56, 57, 58, 59, 60, 61, 64, 66, 67, 68, 71, 73, 74, 77, 79, 81, 82, 83, 84, 85, 86, 87, 88, 89, 90, 92, 93, 94, 98, 99, 102, 103, 107, 108, 110, 112, 113, 114, 116, 121, 122, 123, 124, 126, 129, 130, 131, 133, 135, 136, 138, 139, 145, 149, 150, 151, 156, 163, 164, 165]"
tqdm,14373,623,413,210,"[1, 2, 4, 5, 7, 13, 15, 21, 24, 25, 28, 30, 32, 33, 37, 38, 39, 40, 41, 48, 50, 51, 54, 59, 62, 64, 65, 67, 70, 71, 72, 73, 77, 78, 80, 81, 83, 84, 89, 97, 99, 100, 101, 103, 104, 105, 108, 109, 113, 114, 115, 116, 121, 122, 123, 126, 127, 128, 129, 130, 131, 133, 134, 135, 140, 141, 144, 145, 146, 148, 149, 155, 156, 157, 161, 164, 165, 166, 168, 169, 170, 172, 173, 175, 176, 178, 180, 182, 184, 185, 186, 187, 188, 189, 191, 193, 194, 197, 200, 202]"
SpringAll,14367,29,22,7,"[1, 2, 3, 4, 5, 6, 7, 8, 9, 10, 11, 12, 13, 14, 15, 17, 18, 19, 20, 21, 22, 24, 25, 26, 27, 28, 29, 31, 32]"
TensorFlow-Course,14367,9,9,0,"[2, 3, 19, 20, 23, 28, 29, 30, 31]"
mars,14366,699,530,169,"[1, 3, 4, 5, 6, 7, 8, 9, 11, 14, 15, 16, 17, 18, 19, 20, 21, 22, 23, 27, 28, 30, 32, 34, 37, 38, 40, 42, 43, 45, 46, 47, 49, 50, 51, 53, 54, 55, 56, 59, 60, 61, 62, 67, 68, 71, 75, 77, 78, 79, 80, 81, 82, 84, 85, 86, 87, 88, 89, 90, 91, 94, 95, 96, 97, 98, 99, 100, 101, 102, 103, 104, 106, 107, 108, 109, 110, 111, 113, 114, 115, 116, 118, 119, 120, 121, 122, 123, 124, 125, 126, 127, 128, 129, 130, 132, 133, 134, 135, 136]"
postgrest,14345,928,832,96,"[1, 2, 3, 4, 5, 6, 7, 8, 9, 10, 11, 12, 13, 14, 15, 16, 17, 18, 19, 20, 21, 22, 23, 24, 25, 26, 27, 28, 29, 30, 31, 33, 35, 36, 37, 38, 39, 40, 42, 43, 44, 45, 48, 51, 52, 53, 54, 56, 58, 63, 66, 68, 70, 71, 77, 85, 87, 88, 92, 94, 95, 96, 97, 98, 99, 100, 101, 102, 103, 104, 105, 106, 107, 108, 109, 110, 111, 112, 113, 114, 115, 116, 117, 118, 119, 120, 122, 123, 124, 125, 126, 127, 129, 130, 131, 132, 133, 134, 135, 136]"
cocos2d-x,14340,4771,3496,1275,"[124, 262, 304, 323, 399, 518, 536, 552, 566, 576, 582, 620, 626, 673, 674, 687, 689, 720, 732, 745, 757, 763, 776, 785, 808, 822, 859, 861, 862, 867, 888, 916, 938, 963, 1054, 1056, 1078, 1079, 1080, 1081, 1083, 1084, 1093, 1095, 1101, 1104, 1106, 1110, 1145, 1161, 1169, 1178, 1223, 1225, 1268, 1283, 1291, 1293, 1304, 1307, 1309, 1313, 1315, 1317, 1326, 1330, 1332, 1335, 1340, 1349, 1351, 1356, 1391, 1399, 1407, 1409, 1423, 1424, 1429, 1432, 1440, 1448, 1450, 1468, 1484, 1489, 1494, 1495, 1508, 1517, 1534, 1546, 1558, 1568, 1571, 1572, 1573, 1574, 1575, 1577]"
Carbon,14335,900,891,9,"[2, 4, 6, 7, 8, 9, 11, 12, 13, 15, 24, 28, 29, 30, 32, 37, 43, 46, 54, 55, 56, 66, 72, 73, 74, 77, 78, 82, 83, 85, 87, 88, 89, 92, 95, 96, 98, 99, 101, 102, 103, 107, 109, 110, 113, 115, 116, 117, 120, 122, 126, 128, 129, 131, 132, 133, 134, 140, 146, 151, 153, 155, 156, 157, 168, 170, 171, 172, 175, 177, 178, 180, 182, 186, 188, 196, 197, 201, 215, 216, 217, 218, 219, 220, 221, 222, 223, 224, 225, 226, 228, 229, 231, 232, 236, 237, 240, 241, 242, 245]"
react-sketchapp,14333,285,260,25,"[1, 3, 5, 6, 7, 8, 9, 10, 11, 12, 13, 14, 15, 16, 17, 19, 20, 23, 25, 26, 27, 28, 29, 31, 32, 33, 34, 36, 37, 38, 39, 40, 41, 42, 43, 44, 46, 47, 48, 49, 50, 51, 52, 54, 56, 57, 58, 63, 65, 67, 68, 70, 71, 72, 73, 74, 75, 76, 77, 78, 79, 80, 81, 82, 83, 84, 85, 86, 87, 88, 89, 90, 92, 93, 94, 97, 98, 99, 100, 101, 102, 104, 106, 107, 109, 112, 114, 119, 120, 121, 122, 123, 125, 128, 129, 132, 133, 136, 138, 139]"
dnSpy,14328,1357,1222,135,"[1, 2, 3, 4, 5, 6, 7, 8, 9, 10, 11, 12, 13, 14, 15, 16, 17, 18, 19, 21, 23, 24, 25, 26, 27, 30, 31, 32, 33, 34, 35, 36, 37, 38, 39, 40, 41, 42, 44, 45, 46, 47, 48, 49, 51, 53, 55, 56, 57, 58, 59, 60, 61, 62, 63, 64, 65, 66, 67, 70, 71, 72, 73, 74, 76, 77, 78, 80, 81, 82, 83, 84, 85, 87, 88, 91, 92, 93, 94, 95, 96, 97, 98, 99, 100, 101, 102, 103, 104, 105, 106, 107, 109, 110, 111, 112, 113, 114, 115, 116]"
easyexcel,14322,1185,1164,21,"[1, 2, 3, 4, 5, 8, 9, 10, 11, 12, 13, 14, 15, 16, 17, 18, 19, 20, 21, 22, 24, 25, 26, 27, 28, 30, 32, 33, 35, 37, 38, 39, 40, 41, 42, 43, 44, 46, 47, 48, 49, 50, 51, 52, 53, 54, 55, 56, 57, 59, 60, 61, 62, 63, 64, 65, 66, 67, 68, 70, 71, 73, 74, 75, 76, 77, 78, 79, 80, 81, 82, 83, 84, 85, 86, 87, 88, 90, 91, 92, 93, 94, 95, 96, 97, 98, 99, 100, 101, 102, 104, 105, 106, 107, 108, 109, 110, 111, 112, 113]"
libra,14317,674,446,228,"[3, 5, 7, 8, 12, 15, 17, 18, 19, 20, 21, 22, 23, 24, 27, 29, 30, 31, 32, 34, 35, 36, 38, 39, 40, 41, 42, 43, 44, 45, 46, 47, 49, 51, 52, 54, 55, 56, 57, 58, 60, 61, 63, 65, 66, 67, 68, 71, 72, 74, 75, 76, 77, 78, 79, 80, 81, 82, 84, 85, 86, 88, 89, 91, 92, 93, 94, 95, 96, 98, 99, 100, 101, 102, 103, 104, 105, 106, 107, 108, 109, 110, 111, 112, 114, 115, 116, 117, 118, 121, 124, 125, 126, 128, 129, 135, 136, 137, 138, 139]"
lime,14316,401,380,21,"[8, 9, 10, 11, 12, 13, 14, 15, 16, 17, 18, 19, 20, 21, 22, 23, 24, 25, 26, 27, 28, 29, 30, 31, 32, 33, 34, 35, 36, 37, 38, 39, 40, 41, 42, 43, 44, 45, 46, 47, 48, 49, 50, 51, 52, 53, 54, 55, 56, 57, 58, 59, 60, 61, 62, 63, 64, 65, 66, 67, 68, 69, 70, 71, 72, 73, 74, 75, 76, 77, 78, 79, 80, 81, 82, 83, 84, 85, 86, 87, 88, 89, 90, 91, 92, 93, 94, 95, 96, 97, 98, 99, 100, 101, 102, 103, 104, 105, 106, 107]"
pyspider,14313,791,541,250,"[1, 2, 3, 4, 5, 6, 7, 8, 9, 10, 11, 12, 13, 14, 15, 16, 17, 18, 19, 20, 23, 26, 28, 30, 31, 32, 33, 34, 35, 36, 37, 38, 39, 40, 41, 42, 43, 45, 46, 47, 48, 49, 50, 51, 52, 53, 54, 55, 57, 58, 59, 60, 61, 62, 63, 66, 67, 68, 69, 70, 71, 72, 73, 74, 75, 76, 78, 79, 80, 81, 82, 84, 85, 87, 88, 89, 90, 91, 92, 93, 94, 95, 96, 97, 98, 99, 100, 101, 102, 103, 104, 106, 107, 108, 109, 110, 111, 114, 115, 116]"
material-components-web,14311,2461,2171,290,"[1, 2, 3, 4, 5, 6, 7, 8, 9, 10, 11, 12, 13, 14, 15, 16, 17, 18, 19, 20, 21, 22, 23, 24, 25, 26, 27, 28, 29, 30, 31, 32, 33, 34, 35, 36, 37, 38, 39, 40, 41, 42, 43, 44, 45, 46, 47, 48, 49, 50, 51, 52, 53, 54, 55, 56, 57, 58, 59, 60, 61, 62, 63, 64, 65, 67, 70, 71, 79, 89, 90, 93, 102, 105, 107, 109, 110, 111, 112, 113, 119, 120, 124, 125, 127, 128, 130, 131, 134, 137, 138, 143, 144, 145, 147, 148, 149, 150, 152, 153]"
solarized,14310,244,95,149,"[1, 4, 6, 7, 8, 15, 17, 19, 20, 21, 22, 23, 24, 28, 31, 32, 34, 35, 36, 37, 39, 42, 45, 51, 53, 55, 56, 60, 62, 63, 64, 66, 67, 70, 71, 73, 74, 76, 77, 78, 79, 81, 82, 84, 85, 86, 87, 88, 89, 90, 91, 93, 97, 98, 99, 100, 101, 102, 104, 105, 106, 107, 108, 111, 112, 113, 114, 116, 117, 118, 119, 120, 121, 122, 123, 124, 126, 127, 131, 136, 138, 139, 140, 141, 142, 143, 146, 148, 149, 150, 151, 152, 153, 155, 156, 157, 158, 159, 162, 164]"
homebridge,14304,2234,2213,21,"[1, 2, 3, 5, 6, 7, 11, 14, 15, 17, 18, 21, 23, 24, 27, 30, 31, 32, 33, 34, 38, 41, 42, 44, 47, 48, 49, 51, 53, 57, 58, 60, 62, 65, 67, 68, 69, 71, 72, 73, 74, 76, 78, 82, 84, 85, 89, 90, 91, 92, 95, 97, 98, 99, 102, 103, 104, 105, 106, 107, 108, 109, 110, 111, 112, 113, 114, 115, 117, 118, 119, 120, 122, 123, 126, 128, 131, 133, 134, 136, 137, 139, 140, 141, 142, 143, 146, 148, 149, 151, 153, 160, 161, 162, 163, 168, 172, 176, 178, 180]"
hacker-laws,14290,128,40,88,"[2, 3, 4, 5, 6, 7, 12, 13, 14, 15, 18, 19, 20, 21, 22, 23, 24, 25, 26, 28, 29, 31, 33, 39, 40, 41, 42, 43, 44, 45, 46, 48, 49, 50, 51, 54, 55, 56, 61, 67, 69, 70, 73, 75, 80, 81, 82, 83, 84, 85, 86, 90, 91, 92, 95, 102, 103, 104, 106, 107, 108, 109, 110, 111, 112, 114, 117, 122, 126, 133, 134, 135, 142, 144, 145, 148, 153, 157, 158, 159, 160, 163, 166, 168, 169, 170, 171, 172, 173, 175, 177, 180, 181, 187, 189, 191, 196, 198, 200, 202]"
inferno,14290,814,782,32,"[1, 2, 3, 5, 6, 7, 8, 9, 10, 12, 13, 14, 16, 17, 18, 21, 22, 29, 31, 33, 34, 35, 39, 41, 42, 43, 44, 45, 46, 48, 49, 54, 55, 59, 60, 61, 62, 70, 71, 75, 76, 77, 79, 82, 83, 84, 87, 88, 89, 90, 91, 92, 93, 94, 97, 99, 100, 101, 103, 106, 108, 112, 113, 114, 115, 117, 125, 131, 132, 133, 134, 135, 136, 137, 138, 139, 140, 141, 142, 143, 144, 145, 146, 147, 148, 149, 150, 151, 152, 153, 155, 156, 157, 159, 160, 161, 162, 164, 167, 168]"
fastify,14287,890,840,50,"[7, 8, 9, 10, 11, 12, 23, 24, 29, 30, 31, 32, 33, 34, 37, 39, 41, 44, 48, 50, 51, 55, 58, 59, 63, 64, 66, 68, 69, 76, 77, 81, 84, 85, 87, 92, 100, 102, 103, 104, 106, 107, 118, 120, 121, 122, 123, 129, 130, 133, 134, 135, 136, 139, 140, 146, 147, 148, 151, 158, 159, 160, 161, 163, 165, 169, 173, 174, 176, 178, 179, 180, 181, 185, 186, 188, 190, 191, 193, 194, 197, 199, 200, 202, 206, 207, 208, 210, 211, 212, 214, 216, 219, 220, 225, 227, 229, 231, 235, 237]"
flatbuffers,14256,1319,1113,206,"[1, 2, 3, 4, 6, 7, 9, 10, 12, 14, 15, 18, 19, 20, 21, 24, 25, 27, 28, 29, 30, 31, 32, 33, 34, 37, 38, 41, 42, 43, 47, 48, 49, 50, 51, 52, 54, 55, 56, 59, 60, 61, 62, 63, 64, 65, 68, 69, 71, 72, 74, 75, 77, 79, 81, 82, 83, 84, 85, 86, 87, 88, 89, 90, 91, 94, 95, 96, 97, 98, 99, 100, 102, 103, 104, 105, 116, 117, 118, 120, 122, 123, 124, 126, 130, 135, 136, 139, 145, 148, 152, 153, 154, 161, 162, 167, 170, 171, 174, 175]"
professional-programming,14253,7,7,0,"[5, 11, 16, 21, 22, 23, 24]"
reinforcement-learning,14252,141,55,86,"[2, 3, 4, 7, 9, 12, 13, 14, 15, 16, 18, 19, 21, 22, 23, 24, 25, 26, 28, 29, 30, 33, 34, 35, 37, 40, 41, 42, 43, 44, 45, 46, 47, 48, 49, 50, 51, 52, 53, 54, 55, 56, 57, 58, 62, 63, 64, 66, 68, 69, 70, 72, 74, 76, 78, 79, 80, 83, 84, 87, 88, 89, 91, 92, 93, 94, 95, 100, 101, 103, 106, 108, 109, 110, 112, 114, 116, 117, 122, 124, 125, 127, 128, 130, 131, 132, 133, 135, 136, 138, 139, 140, 141, 142, 147, 149, 150, 151, 152, 153]"
games,14243,198,75,123,"[19, 22, 24, 26, 34, 36, 39, 45, 46, 51, 53, 54, 59, 60, 61, 62, 67, 71, 74, 76, 80, 88, 89, 90, 91, 92, 94, 97, 103, 104, 106, 107, 110, 112, 113, 114, 115, 120, 130, 131, 134, 138, 143, 146, 148, 149, 152, 154, 156, 161, 167, 168, 171, 175, 177, 181, 186, 189, 192, 197, 198, 201, 202, 205, 211, 212, 213, 218, 219, 222, 224, 225, 226, 227, 229, 247, 248, 251, 252, 254, 255, 256, 257, 258, 259, 260, 262, 263, 265, 266, 267, 268, 269, 272, 275, 277, 280, 284, 285, 295]"
Android-CleanArchitecture,14238,246,121,125,"[1, 2, 3, 4, 5, 7, 8, 9, 10, 11, 12, 13, 14, 16, 17, 18, 19, 21, 22, 24, 26, 27, 28, 29, 30, 32, 33, 36, 37, 38, 39, 40, 41, 42, 44, 45, 47, 48, 54, 55, 57, 58, 59, 60, 61, 62, 63, 64, 65, 66, 67, 68, 69, 70, 71, 72, 74, 75, 76, 77, 78, 79, 80, 87, 88, 89, 90, 91, 92, 94, 97, 100, 101, 102, 104, 105, 106, 108, 109, 110, 111, 112, 113, 114, 115, 117, 118, 119, 120, 121, 122, 123, 124, 125, 126, 127, 128, 129, 130, 132]"
WaveFunctionCollapse,14235,35,32,3,"[2, 3, 8, 11, 14, 19, 20, 22, 23, 24, 25, 27, 28, 29, 30, 32, 33, 34, 35, 36, 37, 38, 39, 40, 41, 42, 45, 51, 52, 55, 56, 58, 60, 63, 64]"
react-developer-roadmap,14226,38,18,20,"[4, 5, 6, 11, 12, 15, 17, 24, 25, 26, 34, 40, 43, 44, 45, 46, 47, 48, 49, 56, 59, 61, 65, 66, 68, 69, 70, 73, 75, 76, 77, 78, 80, 84, 85, 89, 91, 99]"
IQKeyboardManager,14222,1537,1507,30,"[1, 2, 4, 8, 9, 10, 11, 13, 14, 15, 16, 21, 22, 23, 24, 25, 26, 27, 28, 30, 31, 33, 34, 35, 36, 37, 38, 39, 40, 41, 42, 43, 44, 45, 47, 49, 50, 51, 52, 53, 54, 55, 56, 57, 58, 61, 62, 63, 65, 66, 67, 68, 69, 70, 71, 72, 73, 74, 75, 76, 77, 78, 79, 80, 81, 82, 83, 84, 86, 87, 88, 89, 90, 91, 92, 93, 95, 96, 97, 98, 99, 100, 101, 103, 104, 105, 106, 107, 108, 109, 110, 111, 112, 113, 114, 115, 117, 118, 119, 120]"
DoraemonKit,14218,325,308,17,"[3, 4, 5, 6, 7, 8, 9, 10, 13, 14, 17, 19, 20, 21, 22, 24, 25, 26, 27, 28, 29, 30, 32, 35, 38, 39, 40, 41, 43, 45, 46, 50, 51, 52, 53, 54, 55, 59, 61, 62, 64, 65, 66, 67, 68, 69, 70, 71, 73, 74, 75, 76, 77, 78, 79, 80, 81, 82, 83, 86, 89, 90, 91, 93, 94, 95, 96, 97, 98, 101, 102, 103, 104, 105, 106, 107, 109, 110, 111, 112, 114, 115, 116, 117, 118, 120, 121, 123, 125, 126, 127, 128, 129, 130, 132, 133, 134, 135, 136, 137]"
rancher,14215,22248,19630,2618,"[1, 2, 4, 5, 6, 8, 10, 11, 13, 14, 15, 16, 18, 19, 20, 22, 23, 24, 25, 26, 27, 28, 29, 30, 31, 32, 33, 34, 35, 36, 38, 39, 40, 41, 42, 43, 44, 45, 46, 47, 48, 49, 52, 53, 54, 55, 58, 59, 60, 61, 62, 63, 64, 65, 66, 67, 68, 70, 71, 72, 73, 74, 75, 76, 78, 79, 80, 81, 82, 83, 84, 86, 87, 88, 89, 90, 91, 92, 93, 94, 95, 96, 98, 99, 100, 101, 102, 103, 104, 105, 108, 109, 110, 111, 112, 113, 114, 115, 116, 117]"
riot,14195,2086,2082,4,"[2, 3, 8, 9, 10, 25, 27, 28, 29, 35, 39, 40, 43, 44, 45, 50, 51, 55, 57, 58, 59, 60, 61, 62, 74, 76, 79, 81, 83, 86, 91, 95, 96, 98, 99, 103, 104, 105, 106, 107, 108, 112, 113, 114, 115, 116, 118, 119, 121, 123, 124, 125, 126, 127, 131, 132, 136, 137, 139, 140, 141, 142, 143, 145, 149, 152, 154, 155, 156, 157, 158, 159, 160, 164, 165, 167, 168, 169, 170, 171, 172, 174, 176, 177, 179, 180, 181, 182, 183, 184, 185, 186, 187, 188, 189, 190, 191, 192, 198, 201]"
toBeTopJavaer,14188,33,25,8,"[2, 3, 4, 5, 8, 9, 12, 13, 14, 17, 19, 20, 22, 23, 38, 39, 42, 50, 52, 54, 55, 56, 57, 58, 60, 61, 62, 63, 64, 65, 66, 67, 68]"
kibana,14177,24210,17912,6298,"[1, 4, 5, 6, 7, 8, 9, 10, 11, 12, 13, 14, 15, 16, 17, 18, 19, 20, 22, 23, 24, 25, 26, 27, 28, 32, 36, 37, 41, 43, 44, 45, 46, 48, 54, 58, 59, 60, 61, 64, 66, 70, 71, 72, 74, 75, 80, 81, 83, 84, 86, 88, 89, 90, 91, 93, 94, 95, 96, 97, 98, 99, 100, 104, 105, 107, 112, 114, 115, 116, 117, 118, 120, 124, 128, 129, 130, 131, 139, 141, 142, 143, 146, 147, 148, 149, 150, 151, 159, 160, 162, 163, 165, 166, 168, 169, 170, 171, 172, 179]"
HowToBeAProgrammer,14163,21,17,4,"[1, 3, 11, 15, 16, 33, 34, 38, 43, 45, 49, 50, 56, 59, 64, 67, 68, 75, 109, 115, 119]"
ipython,14161,6343,5045,1298,"[1, 2, 3, 4, 5, 6, 7, 8, 9, 10, 11, 12, 13, 14, 15, 16, 17, 18, 19, 20, 21, 22, 23, 24, 25, 26, 27, 28, 29, 30, 31, 32, 33, 34, 35, 36, 37, 38, 39, 40, 41, 42, 43, 44, 45, 46, 47, 48, 49, 50, 51, 52, 53, 54, 55, 56, 57, 58, 59, 60, 61, 62, 63, 64, 65, 66, 67, 68, 69, 70, 71, 72, 73, 74, 75, 76, 77, 78, 79, 80, 81, 82, 83, 84, 85, 86, 87, 88, 89, 90, 91, 92, 93, 94, 95, 96, 97, 98, 99, 100]"
Best-App,14153,65,30,35,"[1, 2, 3, 4, 7, 8, 9, 10, 14, 15, 19, 20, 22, 30, 31, 32, 33, 38, 39, 41, 44, 48, 50, 56, 57, 61, 66, 67, 73, 75, 76, 77, 78, 80, 81, 82, 84, 87, 88, 89, 90, 91, 93, 94, 95, 96, 98, 99, 100, 101, 103, 105, 106, 108, 109, 110, 111, 112, 113, 114, 115, 116, 117, 118, 120]"
draggable,14098,225,123,102,"[2, 4, 5, 6, 7, 8, 9, 10, 13, 15, 16, 17, 18, 21, 27, 31, 33, 34, 35, 36, 37, 39, 40, 44, 45, 46, 48, 50, 51, 53, 54, 55, 56, 57, 58, 60, 61, 62, 64, 65, 66, 67, 68, 69, 71, 72, 73, 74, 75, 77, 78, 79, 81, 82, 83, 84, 85, 86, 87, 89, 90, 91, 92, 93, 96, 97, 98, 99, 100, 101, 103, 104, 105, 106, 107, 108, 109, 110, 113, 114, 116, 121, 122, 128, 129, 130, 131, 132, 136, 139, 141, 147, 148, 149, 150, 151, 153, 155, 156, 157]"
svgo,14074,897,625,272,"[2, 3, 4, 5, 6, 7, 8, 9, 10, 11, 12, 13, 14, 15, 16, 17, 18, 19, 20, 21, 22, 23, 24, 25, 26, 27, 28, 29, 30, 31, 32, 33, 34, 35, 36, 37, 38, 39, 40, 41, 42, 43, 44, 45, 46, 47, 48, 49, 50, 51, 52, 53, 54, 55, 56, 57, 58, 59, 60, 61, 62, 63, 64, 65, 66, 67, 68, 69, 70, 71, 72, 73, 74, 75, 76, 77, 78, 79, 80, 83, 84, 85, 86, 87, 88, 89, 90, 92, 93, 94, 95, 96, 97, 98, 99, 100, 101, 102, 103, 104]"
prepack,14070,767,561,206,"[14, 15, 16, 17, 18, 19, 20, 21, 22, 23, 24, 25, 26, 27, 28, 29, 30, 31, 32, 33, 34, 35, 337, 338, 342, 343, 356, 357, 360, 370, 377, 378, 380, 395, 396, 403, 405, 410, 412, 413, 415, 416, 422, 424, 431, 437, 439, 444, 446, 447, 449, 451, 452, 453, 454, 456, 462, 467, 472, 473, 474, 475, 476, 482, 485, 486, 489, 490, 491, 492, 494, 495, 496, 498, 499, 500, 501, 503, 515, 517, 518, 519, 520, 521, 522, 523, 526, 527, 528, 529, 532, 534, 535, 537, 538, 539, 541, 542, 543, 544]"
FileSaver.js,14057,510,432,78,"[1, 2, 3, 4, 5, 6, 7, 8, 9, 10, 11, 12, 13, 14, 17, 18, 19, 20, 21, 22, 23, 24, 25, 26, 27, 28, 29, 30, 32, 35, 41, 42, 44, 46, 48, 51, 52, 54, 55, 56, 58, 60, 61, 62, 65, 66, 67, 69, 72, 73, 74, 75, 77, 78, 79, 80, 81, 82, 83, 84, 85, 86, 87, 88, 89, 90, 91, 92, 93, 94, 98, 100, 101, 103, 104, 106, 107, 108, 110, 111, 114, 115, 116, 117, 118, 119, 120, 121, 123, 124, 125, 126, 127, 128, 129, 130, 132, 133, 134, 135]"
jsdom,14051,1776,1489,287,"[1, 2, 3, 4, 5, 6, 7, 8, 9, 10, 11, 12, 13, 14, 15, 16, 20, 25, 27, 29, 34, 36, 38, 41, 42, 43, 45, 46, 48, 51, 56, 57, 58, 61, 64, 68, 72, 73, 77, 78, 79, 81, 82, 83, 87, 88, 89, 90, 92, 95, 96, 99, 100, 104, 106, 107, 111, 113, 114, 115, 116, 117, 118, 119, 123, 124, 125, 127, 131, 132, 135, 136, 137, 141, 143, 145, 146, 147, 148, 149, 153, 154, 155, 156, 158, 159, 160, 161, 163, 165, 168, 169, 170, 171, 172, 173, 174, 175, 176, 177]"
homemade-machine-learning,13984,18,7,11,"[1, 2, 3, 4, 5, 6, 8, 9, 10, 15, 16, 17, 20, 21, 22, 23, 24, 29]"
GSYVideoPlayer,13936,2596,2579,17,"[1, 2, 3, 4, 5, 6, 7, 8, 9, 10, 11, 12, 13, 14, 15, 16, 17, 18, 19, 20, 21, 22, 23, 24, 25, 26, 27, 28, 29, 30, 31, 32, 33, 34, 35, 36, 37, 38, 39, 40, 41, 42, 43, 44, 45, 46, 47, 48, 50, 51, 52, 53, 54, 55, 56, 57, 58, 59, 60, 61, 62, 63, 64, 65, 66, 67, 68, 69, 70, 71, 72, 73, 74, 75, 76, 77, 78, 79, 80, 81, 82, 83, 84, 85, 86, 87, 88, 89, 90, 91, 92, 93, 94, 95, 96, 97, 98, 99, 100, 101]"
ws,13933,1148,1142,6,"[2, 4, 13, 14, 15, 17, 18, 20, 21, 22, 23, 24, 25, 26, 28, 29, 30, 31, 32, 34, 35, 36, 37, 38, 39, 40, 42, 43, 44, 50, 51, 52, 53, 54, 57, 58, 62, 64, 66, 68, 69, 70, 71, 72, 74, 76, 77, 78, 81, 82, 83, 85, 86, 87, 88, 92, 93, 95, 98, 99, 101, 102, 104, 107, 108, 109, 110, 111, 112, 113, 114, 115, 116, 117, 118, 119, 121, 122, 123, 127, 128, 129, 130, 131, 132, 136, 139, 141, 142, 144, 145, 146, 147, 148, 151, 152, 154, 155, 159, 160]"
wechat_jump_game,13914,984,958,26,"[1, 2, 3, 4, 5, 6, 8, 11, 13, 14, 15, 16, 17, 18, 19, 20, 21, 23, 24, 25, 28, 29, 30, 31, 32, 36, 37, 38, 39, 40, 41, 42, 44, 45, 47, 48, 49, 50, 51, 52, 53, 54, 55, 57, 59, 60, 61, 62, 63, 64, 65, 66, 68, 69, 70, 71, 73, 75, 76, 77, 79, 80, 81, 82, 83, 84, 85, 86, 87, 88, 89, 90, 91, 93, 94, 95, 96, 97, 98, 99, 100, 101, 102, 103, 104, 105, 107, 108, 109, 111, 112, 113, 114, 115, 116, 117, 118, 119, 120, 121]"
Telegram,13910,0,0,0,[]
recharts,13910,1787,1675,112,"[1, 13, 14, 17, 20, 21, 22, 23, 24, 25, 26, 27, 28, 29, 30, 31, 34, 35, 36, 37, 38, 39, 40, 41, 43, 47, 49, 50, 51, 52, 55, 56, 57, 58, 59, 61, 62, 63, 64, 67, 71, 75, 76, 79, 82, 84, 87, 88, 90, 91, 93, 94, 95, 98, 99, 100, 102, 103, 104, 106, 107, 109, 111, 112, 113, 115, 117, 120, 121, 122, 123, 124, 125, 129, 130, 132, 134, 135, 136, 137, 138, 139, 142, 143, 144, 145, 146, 147, 148, 149, 150, 152, 153, 154, 155, 156, 157, 159, 160, 161]"
Awesome-Linux-Software,13907,99,92,7,"[10, 13, 15, 33, 34, 35, 42, 44, 45, 47, 63, 71, 75, 77, 83, 88, 92, 93, 101, 104, 105, 109, 113, 115, 116, 123, 125, 128, 129, 130, 135, 146, 147, 148, 155, 160, 173, 175, 176, 179, 181, 188, 194, 195, 196, 201, 202, 203, 204, 206, 207, 209, 210, 213, 214, 215, 221, 223, 224, 226, 227, 228, 231, 233, 234, 235, 237, 238, 239, 241, 242, 245, 246, 250, 283, 287, 312, 313, 325, 326, 337, 338, 339, 345, 346, 352, 366, 368, 370, 375, 383, 387, 419, 433, 445, 473, 474, 475, 497]"
git-extras,13881,302,217,85,"[1, 2, 3, 7, 9, 14, 15, 16, 17, 20, 22, 23, 25, 27, 28, 29, 32, 33, 34, 36, 37, 38, 40, 45, 47, 52, 54, 55, 56, 66, 67, 69, 70, 71, 72, 73, 74, 75, 76, 78, 79, 85, 86, 90, 92, 95, 96, 97, 101, 106, 115, 127, 132, 134, 135, 137, 138, 142, 144, 150, 156, 161, 164, 167, 170, 176, 180, 182, 186, 190, 196, 198, 203, 207, 209, 211, 215, 217, 228, 232, 233, 234, 237, 241, 245, 246, 259, 265, 266, 267, 269, 274, 277, 279, 282, 285, 286, 290, 295, 297]"
REKCARC-TSC-UHT,13872,17,9,8,"[1, 2, 4, 5, 7, 27, 28, 30, 32, 37, 38, 40, 43, 45, 53, 62, 63]"
DeepSpeech,13862,1673,1605,68,"[1, 2, 3, 4, 5, 6, 7, 8, 9, 10, 11, 12, 13, 14, 15, 16, 17, 18, 19, 20, 21, 22, 23, 24, 25, 26, 27, 28, 29, 30, 31, 32, 33, 34, 35, 37, 39, 40, 46, 47, 48, 53, 54, 57, 59, 61, 62, 63, 65, 67, 69, 71, 72, 73, 75, 78, 79, 80, 81, 82, 83, 85, 87, 88, 90, 92, 94, 96, 99, 101, 105, 106, 107, 108, 109, 110, 111, 113, 114, 115, 120, 124, 126, 128, 129, 131, 132, 133, 134, 135, 138, 141, 144, 148, 149, 150, 156, 158, 160, 163]"
gotty,13861,191,118,73,"[1, 2, 3, 4, 7, 8, 10, 15, 16, 17, 18, 19, 20, 21, 22, 23, 24, 25, 28, 29, 30, 31, 32, 33, 34, 35, 36, 37, 38, 39, 40, 41, 42, 45, 46, 47, 48, 49, 50, 51, 52, 53, 54, 55, 56, 58, 59, 60, 61, 62, 65, 70, 72, 73, 78, 79, 80, 81, 82, 83, 84, 88, 89, 90, 92, 94, 96, 97, 98, 99, 100, 103, 104, 105, 108, 109, 110, 111, 116, 118, 119, 120, 122, 125, 126, 127, 128, 129, 132, 133, 134, 136, 140, 141, 143, 144, 146, 147, 148, 149]"
f8app,13860,203,187,16,"[2, 4, 5, 6, 7, 8, 9, 10, 11, 13, 15, 16, 17, 18, 19, 20, 21, 22, 23, 24, 25, 26, 27, 28, 29, 30, 32, 33, 34, 35, 36, 38, 39, 40, 41, 42, 44, 45, 46, 47, 48, 49, 50, 51, 52, 53, 54, 55, 56, 57, 58, 59, 61, 62, 63, 64, 65, 66, 67, 68, 69, 71, 72, 73, 74, 75, 76, 77, 78, 80, 81, 82, 83, 84, 85, 86, 87, 88, 89, 90, 91, 92, 93, 94, 95, 96, 97, 98, 99, 100, 101, 102, 104, 105, 106, 107, 108, 109, 111, 112]"
realm-cocoa,13851,3951,3499,452,"[595, 597, 598, 599, 601, 602, 604, 605, 608, 611, 612, 617, 620, 621, 622, 624, 625, 627, 628, 638, 647, 651, 652, 653, 655, 664, 667, 668, 672, 673, 677, 682, 683, 684, 685, 686, 687, 688, 689, 690, 692, 694, 699, 700, 709, 713, 716, 717, 725, 726, 730, 731, 732, 733, 738, 746, 748, 749, 750, 752, 754, 757, 763, 773, 781, 782, 786, 788, 789, 796, 799, 800, 801, 803, 809, 810, 813, 816, 817, 818, 823, 824, 836, 840, 841, 848, 849, 853, 854, 855, 858, 862, 863, 870, 874, 875, 878, 890, 898, 899]"
ui-router,13849,3159,3146,13,"[1, 2, 3, 4, 5, 6, 7, 8, 9, 10, 11, 12, 13, 14, 15, 16, 17, 18, 19, 20, 21, 22, 23, 24, 25, 26, 27, 28, 29, 30, 31, 32, 33, 35, 36, 37, 38, 41, 42, 43, 44, 45, 46, 47, 48, 49, 50, 51, 52, 53, 54, 55, 56, 57, 58, 59, 60, 62, 63, 64, 65, 66, 67, 68, 69, 71, 72, 74, 75, 76, 77, 78, 79, 81, 82, 83, 84, 85, 86, 87, 88, 89, 90, 92, 93, 94, 95, 97, 98, 99, 100, 101, 102, 103, 104, 105, 106, 107, 108, 109]"
delve,13845,1062,964,98,"[2, 3, 5, 6, 14, 16, 20, 22, 23, 24, 25, 26, 27, 28, 29, 30, 31, 32, 41, 43, 51, 55, 56, 58, 59, 60, 61, 62, 63, 64, 65, 67, 69, 70, 71, 72, 73, 74, 75, 76, 79, 80, 81, 82, 83, 86, 87, 89, 90, 91, 92, 93, 95, 96, 97, 101, 102, 103, 104, 106, 109, 110, 111, 115, 116, 117, 118, 119, 120, 121, 122, 123, 126, 130, 132, 133, 134, 137, 138, 139, 140, 141, 143, 144, 146, 149, 150, 152, 154, 157, 159, 160, 161, 163, 164, 165, 166, 168, 169, 170]"
mustache.js,13834,426,371,55,"[1, 2, 3, 4, 5, 6, 7, 8, 9, 10, 11, 12, 13, 14, 15, 16, 17, 18, 19, 20, 21, 22, 23, 24, 25, 26, 27, 28, 29, 30, 31, 32, 33, 34, 35, 36, 37, 38, 39, 40, 41, 42, 43, 44, 45, 46, 47, 48, 49, 50, 51, 52, 53, 54, 56, 58, 60, 61, 62, 64, 65, 66, 67, 71, 72, 73, 74, 76, 77, 78, 79, 80, 82, 83, 85, 86, 87, 88, 90, 91, 94, 97, 98, 102, 104, 105, 107, 110, 112, 116, 117, 118, 120, 121, 122, 125, 128, 133, 135, 141]"
DeepFaceLab,13829,642,581,61,"[1, 2, 3, 4, 5, 6, 7, 9, 12, 13, 14, 15, 17, 18, 21, 22, 23, 24, 25, 26, 27, 28, 29, 30, 31, 32, 33, 34, 35, 36, 37, 38, 39, 40, 41, 42, 43, 44, 48, 49, 50, 51, 52, 53, 54, 55, 57, 58, 59, 60, 61, 62, 63, 64, 65, 66, 68, 69, 70, 71, 72, 73, 74, 75, 76, 77, 78, 79, 80, 81, 82, 83, 84, 85, 86, 87, 88, 89, 90, 92, 96, 97, 98, 99, 100, 101, 102, 103, 104, 105, 106, 107, 108, 109, 110, 111, 112, 113, 114, 115]"
eShopOnContainers,13808,845,796,49,"[1, 2, 3, 4, 5, 6, 7, 8, 9, 10, 11, 12, 13, 14, 15, 16, 17, 18, 19, 20, 21, 22, 23, 24, 25, 26, 27, 28, 29, 30, 31, 32, 33, 34, 35, 36, 37, 38, 39, 40, 42, 43, 44, 45, 46, 47, 48, 51, 52, 53, 54, 55, 56, 57, 58, 59, 60, 61, 62, 63, 64, 65, 66, 67, 69, 70, 71, 72, 74, 75, 76, 77, 79, 80, 81, 83, 86, 87, 88, 90, 91, 93, 94, 95, 96, 97, 98, 99, 102, 103, 105, 107, 111, 112, 113, 115, 116, 117, 118, 127]"
terminus,13804,1461,1139,322,"[1, 2, 3, 4, 5, 6, 7, 8, 9, 10, 11, 12, 13, 14, 15, 16, 17, 18, 19, 20, 21, 22, 23, 24, 25, 26, 27, 28, 29, 30, 31, 32, 34, 35, 36, 37, 38, 39, 40, 41, 42, 43, 45, 46, 47, 49, 50, 51, 53, 54, 55, 57, 58, 59, 60, 61, 62, 63, 65, 66, 67, 68, 69, 70, 71, 72, 73, 74, 75, 76, 77, 78, 79, 80, 81, 82, 83, 84, 85, 86, 87, 88, 89, 90, 91, 92, 93, 94, 95, 96, 98, 99, 100, 101, 102, 103, 104, 105, 106, 107]"
WordPress,13793,0,0,0,[]
apollo-client,13757,2722,2191,531,"[1, 2, 3, 6, 9, 14, 15, 25, 26, 27, 29, 30, 31, 33, 35, 36, 40, 41, 42, 44, 45, 46, 47, 48, 49, 50, 51, 52, 53, 54, 57, 58, 59, 60, 61, 62, 63, 64, 65, 71, 73, 78, 79, 80, 82, 83, 84, 85, 86, 88, 90, 91, 92, 93, 95, 98, 99, 102, 103, 105, 106, 107, 108, 109, 110, 113, 114, 115, 116, 120, 123, 124, 127, 128, 130, 131, 132, 135, 136, 137, 139, 141, 142, 143, 144, 145, 146, 147, 148, 149, 150, 151, 152, 155, 156, 157, 158, 159, 160, 161]"
sanic,13744,870,815,55,"[1, 3, 7, 9, 10, 11, 12, 13, 17, 24, 25, 27, 37, 40, 41, 42, 44, 46, 47, 49, 50, 51, 53, 55, 56, 61, 62, 64, 67, 69, 72, 73, 74, 75, 76, 77, 81, 83, 85, 86, 88, 90, 92, 96, 97, 102, 107, 108, 113, 115, 116, 120, 121, 123, 124, 126, 129, 130, 133, 136, 143, 146, 152, 153, 156, 157, 158, 164, 168, 174, 176, 178, 179, 180, 181, 184, 191, 192, 196, 203, 204, 205, 206, 207, 208, 219, 221, 227, 241, 245, 247, 250, 251, 254, 256, 257, 258, 262, 263, 267]"
NativeBase,13721,2442,2225,217,"[3, 4, 5, 6, 7, 10, 11, 12, 13, 14, 15, 16, 17, 18, 19, 20, 21, 22, 23, 24, 25, 26, 27, 28, 29, 30, 32, 33, 34, 35, 36, 37, 38, 39, 41, 42, 44, 45, 46, 47, 48, 49, 50, 51, 52, 53, 54, 55, 56, 57, 58, 60, 61, 62, 63, 64, 65, 66, 67, 68, 69, 70, 71, 72, 73, 74, 75, 76, 78, 79, 80, 81, 82, 83, 84, 85, 86, 87, 88, 89, 90, 91, 92, 93, 94, 95, 96, 97, 98, 99, 100, 101, 102, 103, 104, 105, 106, 107, 108, 110]"
SpaceVim,13717,1719,1671,48,"[1, 2, 4, 5, 6, 8, 9, 10, 12, 13, 16, 17, 20, 21, 22, 24, 25, 26, 28, 29, 31, 32, 33, 35, 36, 37, 41, 43, 44, 46, 48, 49, 50, 51, 52, 57, 61, 62, 63, 64, 69, 71, 72, 73, 75, 78, 81, 83, 84, 85, 87, 89, 91, 93, 94, 97, 99, 100, 105, 107, 108, 109, 110, 111, 114, 118, 120, 121, 123, 124, 125, 126, 129, 130, 133, 135, 136, 140, 141, 143, 144, 155, 156, 157, 159, 161, 164, 166, 167, 169, 170, 171, 173, 176, 177, 182, 183, 184, 192, 193]"
ccxt,13709,4400,4079,321,"[2, 3, 4, 5, 6, 7, 8, 9, 10, 11, 12, 13, 14, 16, 17, 18, 19, 20, 21, 22, 23, 24, 25, 26, 27, 28, 29, 30, 31, 32, 33, 35, 36, 38, 39, 40, 41, 42, 43, 44, 46, 48, 50, 52, 53, 54, 55, 56, 57, 58, 60, 62, 63, 64, 65, 66, 67, 68, 69, 70, 71, 74, 75, 76, 77, 78, 79, 80, 81, 82, 83, 84, 85, 86, 87, 88, 89, 90, 91, 94, 95, 96, 100, 104, 105, 108, 110, 113, 114, 115, 119, 120, 121, 122, 124, 125, 126, 127, 129, 130]"
Perfect,13702,183,134,49,"[1, 2, 3, 6, 7, 9, 10, 11, 12, 13, 14, 17, 18, 20, 21, 22, 23, 24, 25, 26, 28, 29, 30, 32, 34, 35, 36, 37, 38, 40, 41, 43, 44, 45, 46, 47, 48, 49, 50, 51, 52, 54, 56, 58, 59, 61, 62, 63, 65, 69, 75, 77, 86, 89, 92, 96, 98, 99, 100, 101, 104, 105, 106, 107, 110, 111, 112, 115, 116, 118, 119, 120, 121, 123, 126, 127, 128, 131, 133, 134, 138, 140, 143, 144, 145, 146, 147, 148, 149, 150, 151, 153, 154, 155, 156, 157, 158, 159, 161, 162]"
Carthage,13672,1873,1725,148,"[3, 5, 6, 7, 8, 9, 10, 11, 12, 15, 18, 19, 20, 29, 35, 36, 37, 38, 39, 40, 44, 48, 49, 50, 51, 56, 59, 60, 61, 62, 63, 64, 66, 67, 68, 70, 71, 73, 76, 79, 80, 81, 85, 87, 88, 89, 91, 94, 95, 96, 100, 101, 102, 105, 106, 107, 108, 111, 112, 113, 114, 115, 116, 119, 120, 121, 122, 124, 125, 126, 127, 128, 132, 133, 134, 135, 136, 137, 138, 139, 140, 142, 143, 144, 145, 147, 150, 151, 152, 154, 157, 158, 159, 160, 161, 162, 163, 164, 166, 169]"
xxl-job,13669,1433,1349,84,"[1, 2, 4, 5, 6, 7, 8, 9, 10, 11, 12, 13, 14, 16, 17, 19, 21, 22, 24, 25, 26, 28, 29, 30, 31, 33, 34, 35, 36, 37, 38, 39, 40, 41, 43, 44, 45, 46, 48, 49, 50, 51, 53, 54, 55, 57, 58, 59, 60, 61, 62, 63, 64, 66, 67, 68, 69, 70, 71, 72, 75, 76, 77, 78, 79, 80, 81, 82, 83, 84, 86, 87, 89, 91, 92, 94, 95, 97, 98, 99, 100, 101, 102, 103, 106, 107, 109, 110, 111, 112, 114, 115, 116, 117, 118, 121, 122, 123, 124, 125]"
vim-airline,13658,1471,1449,22,"[1, 2, 3, 6, 8, 9, 10, 11, 13, 14, 17, 18, 19, 20, 21, 23, 25, 26, 27, 29, 30, 31, 32, 33, 34, 35, 36, 37, 38, 42, 44, 45, 48, 49, 52, 54, 55, 56, 59, 63, 66, 67, 68, 70, 72, 73, 75, 76, 77, 78, 79, 81, 82, 83, 84, 85, 86, 88, 92, 93, 95, 97, 102, 104, 105, 106, 107, 108, 109, 113, 115, 117, 122, 123, 124, 125, 126, 127, 128, 129, 130, 131, 134, 136, 138, 139, 140, 142, 143, 144, 145, 146, 147, 148, 149, 150, 151, 153, 154, 155]"
pytudes,13645,20,10,10,"[1, 4, 5, 9, 21, 23, 32, 34, 42, 51, 53, 55, 62, 63, 64, 65, 74, 75, 78, 79]"
BullshitGenerator,13641,138,27,111,"[3, 9, 10, 14, 15, 16, 17, 18, 20, 21, 23, 27, 28, 29, 33, 34, 35, 39, 40, 41, 42, 43, 44, 45, 46, 47, 49, 50, 51, 52, 53, 54, 55, 56, 57, 58, 59, 60, 61, 62, 63, 64, 65, 67, 68, 69, 70, 71, 72, 74, 75, 76, 77, 78, 79, 80, 82, 83, 84, 85, 86, 87, 88, 89, 90, 92, 93, 94, 96, 97, 98, 99, 100, 101, 102, 103, 104, 105, 106, 108, 109, 111, 112, 115, 116, 117, 119, 121, 123, 124, 125, 127, 128, 129, 130, 132, 133, 135, 137, 138]"
webpack-dashboard,13633,205,173,32,"[2, 5, 6, 7, 8, 9, 10, 11, 12, 14, 15, 16, 18, 19, 20, 21, 23, 24, 26, 28, 29, 30, 31, 32, 33, 34, 35, 36, 37, 38, 39, 40, 41, 42, 43, 44, 45, 48, 49, 51, 52, 53, 54, 55, 57, 58, 60, 61, 62, 66, 67, 68, 69, 70, 72, 73, 75, 78, 79, 83, 84, 85, 88, 90, 91, 92, 93, 94, 96, 97, 98, 99, 100, 102, 105, 106, 107, 108, 109, 110, 111, 112, 113, 114, 115, 116, 117, 119, 120, 121, 122, 123, 124, 125, 126, 127, 129, 130, 131, 132]"
canal,13625,2315,1871,444,"[1, 2, 3, 4, 5, 6, 7, 8, 9, 10, 11, 12, 13, 14, 16, 17, 18, 19, 20, 21, 22, 23, 24, 25, 26, 27, 28, 29, 30, 31, 32, 33, 34, 35, 36, 37, 38, 39, 40, 41, 42, 43, 44, 47, 48, 49, 50, 51, 52, 53, 54, 55, 56, 57, 58, 59, 60, 61, 62, 63, 64, 65, 66, 67, 68, 69, 70, 71, 72, 73, 74, 75, 76, 77, 78, 79, 80, 81, 82, 83, 84, 85, 86, 87, 88, 89, 90, 91, 92, 93, 94, 95, 96, 97, 99, 100, 103, 105, 106, 107]"
cli,13624,516,446,70,"[1, 2, 3, 4, 5, 6, 7, 8, 10, 12, 14, 15, 16, 25, 27, 28, 29, 31, 34, 37, 39, 41, 44, 45, 46, 47, 54, 55, 56, 60, 62, 64, 66, 69, 72, 85, 87, 88, 89, 90, 91, 92, 97, 100, 101, 102, 103, 104, 105, 107, 110, 117, 119, 120, 125, 126, 129, 130, 131, 132, 133, 136, 138, 142, 144, 145, 148, 149, 158, 160, 161, 162, 163, 164, 165, 174, 175, 176, 179, 183, 184, 188, 189, 190, 191, 203, 204, 206, 207, 208, 210, 212, 216, 219, 220, 221, 222, 223, 224, 228]"
Spring,13623,220,88,132,"[2, 8, 9, 10, 11, 15, 16, 22, 23, 25, 26, 27, 28, 29, 31, 32, 33, 37, 39, 41, 42, 43, 44, 46, 49, 50, 51, 52, 53, 54, 55, 57, 58, 59, 60, 62, 63, 64, 65, 66, 67, 68, 69, 70, 71, 72, 73, 76, 77, 78, 79, 80, 81, 83, 84, 89, 90, 94, 98, 99, 100, 101, 102, 103, 104, 105, 106, 108, 109, 111, 112, 113, 114, 115, 116, 117, 118, 119, 120, 121, 122, 123, 124, 125, 126, 128, 130, 131, 132, 133, 134, 135, 136, 137, 138, 139, 140, 142, 143, 144]"
amphtml,13615,10740,8968,1772,"[1, 2, 3, 4, 5, 6, 8, 11, 13, 14, 15, 19, 20, 21, 25, 26, 28, 30, 31, 32, 33, 34, 35, 37, 42, 44, 46, 48, 51, 53, 54, 56, 58, 61, 62, 63, 64, 66, 67, 69, 70, 71, 72, 74, 76, 77, 78, 79, 81, 82, 83, 84, 85, 86, 87, 89, 91, 92, 93, 96, 97, 100, 103, 110, 111, 112, 113, 116, 122, 124, 125, 133, 136, 137, 138, 139, 140, 142, 146, 149, 150, 151, 154, 155, 156, 157, 162, 163, 165, 167, 170, 172, 173, 174, 176, 178, 180, 181, 189, 190]"
vant,13605,3876,3854,22,"[1, 14, 15, 36, 45, 46, 47, 50, 65, 79, 80, 82, 92, 116, 119, 125, 126, 127, 130, 139, 141, 143, 149, 150, 152, 153, 154, 155, 156, 157, 163, 164, 165, 169, 171, 174, 176, 177, 178, 179, 180, 181, 183, 184, 186, 189, 190, 192, 193, 195, 202, 203, 207, 208, 209, 213, 215, 219, 221, 222, 223, 225, 229, 232, 233, 234, 235, 240, 241, 249, 250, 255, 256, 257, 259, 261, 263, 264, 266, 267, 270, 271, 272, 273, 275, 276, 277, 281, 282, 283, 285, 288, 289, 290, 293, 295, 298, 302, 303, 304]"
numpy,13605,8415,6550,1865,"[291, 294, 311, 312, 314, 315, 316, 319, 320, 329, 338, 346, 347, 368, 369, 370, 378, 380, 381, 382, 383, 385, 387, 389, 391, 392, 394, 396, 398, 399, 402, 403, 406, 407, 408, 409, 410, 411, 412, 413, 414, 415, 416, 421, 424, 426, 427, 428, 434, 437, 438, 442, 448, 450, 453, 456, 464, 465, 467, 468, 469, 470, 471, 473, 474, 478, 479, 481, 485, 486, 487, 488, 489, 490, 491, 492, 493, 494, 495, 496, 497, 498, 499, 500, 501, 502, 503, 504, 505, 506, 507, 508, 509, 510, 511, 512, 513, 514, 515, 516]"
HarmonyOS,13588,0,0,0,[]
blessed-contrib,13580,113,58,55,"[1, 2, 3, 4, 5, 7, 8, 10, 14, 16, 17, 18, 19, 23, 25, 28, 30, 31, 34, 35, 36, 37, 39, 41, 42, 43, 44, 45, 47, 50, 51, 52, 53, 54, 57, 58, 60, 61, 62, 63, 64, 67, 70, 71, 72, 75, 76, 77, 79, 81, 82, 85, 86, 87, 89, 96, 99, 100, 101, 102, 103, 104, 106, 108, 109, 111, 113, 114, 115, 117, 119, 120, 121, 126, 128, 129, 130, 133, 134, 135, 137, 138, 139, 142, 144, 145, 147, 149, 152, 153, 155, 157, 159, 161, 164, 165, 168, 170, 171, 173]"
css-modules,13544,303,218,85,"[3, 4, 6, 7, 8, 9, 10, 11, 12, 13, 14, 17, 18, 19, 20, 21, 22, 23, 24, 25, 26, 27, 28, 30, 31, 32, 33, 34, 35, 36, 37, 38, 39, 40, 41, 42, 44, 45, 46, 47, 48, 49, 50, 51, 52, 53, 54, 55, 56, 57, 58, 59, 60, 61, 63, 64, 66, 67, 68, 69, 70, 71, 72, 74, 75, 77, 78, 79, 80, 81, 82, 83, 84, 85, 86, 87, 88, 89, 90, 91, 92, 95, 96, 97, 98, 99, 100, 101, 102, 103, 104, 105, 106, 107, 109, 110, 111, 112, 113, 115]"
functional-programming-jargon,13543,63,42,21,"[5, 10, 11, 14, 16, 20, 23, 25, 29, 30, 31, 40, 41, 46, 49, 55, 56, 59, 61, 62, 67, 69, 70, 72, 76, 77, 78, 82, 83, 87, 90, 93, 94, 101, 103, 108, 111, 114, 117, 119, 124, 125, 126, 128, 133, 135, 137, 142, 145, 151, 152, 157, 159, 161, 162, 163, 166, 169, 184, 185, 196, 203, 205]"
core,13534,3209,2964,245,"[2, 3, 5, 7, 11, 13, 14, 18, 20, 24, 26, 31, 32, 33, 34, 36, 37, 38, 39, 40, 41, 42, 43, 45, 46, 47, 48, 49, 50, 51, 53, 54, 55, 56, 57, 59, 60, 61, 62, 63, 66, 67, 68, 69, 70, 71, 73, 74, 77, 81, 82, 86, 88, 89, 90, 91, 92, 93, 94, 96, 97, 98, 99, 100, 101, 102, 104, 105, 106, 107, 108, 109, 110, 111, 112, 114, 117, 118, 119, 120, 121, 122, 123, 125, 126, 127, 128, 130, 133, 134, 136, 139, 140, 141, 153, 154, 156, 158, 169, 170]"
incubator-weex,13529,840,688,152,"[1391, 1393, 1396, 1399, 1428, 1430, 1431, 1441, 1448, 1450, 1457, 1459, 1464, 1479, 1480, 1482, 1484, 1486, 1490, 1492, 1493, 1494, 1499, 1502, 1503, 1504, 1508, 1509, 1512, 1513, 1514, 1515, 1519, 1521, 1523, 1524, 1526, 1530, 1558, 1560, 1565, 1576, 1577, 1578, 1584, 1586, 1587, 1590, 1591, 1592, 1594, 1596, 1599, 1604, 1624, 1626, 1627, 1629, 1630, 1631, 1633, 1635, 1637, 1639, 1640, 1642, 1643, 1648, 1649, 1653, 1655, 1657, 1658, 1659, 1671, 1672, 1673, 1674, 1675, 1676, 1677, 1678, 1679, 1681, 1682, 1683, 1684, 1685, 1686, 1687, 1688, 1689, 1690, 1691, 1693, 1694, 1696, 1697, 1698, 1699]"
handsontable,13502,5876,5108,768,"[1, 2, 3, 4, 5, 6, 7, 8, 9, 10, 11, 12, 13, 14, 15, 16, 17, 18, 19, 20, 21, 22, 23, 24, 25, 26, 27, 28, 29, 31, 32, 33, 34, 35, 36, 37, 38, 39, 40, 41, 42, 43, 44, 45, 46, 47, 48, 49, 50, 51, 52, 53, 54, 55, 57, 59, 60, 61, 62, 63, 64, 65, 66, 67, 68, 69, 70, 72, 73, 74, 75, 76, 78, 79, 80, 81, 82, 83, 84, 85, 86, 87, 88, 89, 90, 91, 92, 93, 94, 95, 96, 97, 98, 99, 100, 101, 102, 103, 104, 106]"
30-seconds-of-css,13501,57,57,0,"[2, 3, 4, 7, 10, 11, 14, 15, 17, 22, 26, 28, 29, 30, 33, 36, 41, 42, 46, 48, 50, 52, 59, 60, 61, 64, 66, 76, 80, 82, 83, 85, 86, 88, 91, 92, 99, 102, 106, 110, 118, 120, 128, 133, 136, 137, 139, 140, 147, 148, 151, 162, 164, 166, 167, 172, 180]"
download,13495,0,0,0,[]
YYKit,13491,482,240,242,"[2, 3, 4, 5, 7, 8, 9, 12, 18, 19, 21, 23, 25, 26, 27, 28, 30, 31, 32, 33, 34, 36, 38, 40, 41, 42, 44, 45, 48, 49, 50, 51, 52, 53, 54, 55, 56, 57, 58, 59, 60, 63, 64, 65, 66, 67, 68, 69, 70, 71, 72, 73, 76, 77, 78, 81, 82, 83, 84, 85, 87, 88, 90, 91, 92, 93, 94, 95, 96, 97, 98, 99, 100, 101, 104, 107, 108, 109, 110, 111, 113, 114, 115, 116, 118, 119, 120, 121, 123, 124, 126, 128, 129, 130, 131, 132, 133, 134, 135, 136]"
setup-ipsec-vpn,13487,733,726,7,"[2, 3, 4, 5, 6, 7, 8, 9, 10, 11, 12, 13, 14, 16, 17, 18, 19, 20, 21, 24, 25, 27, 28, 29, 30, 31, 32, 33, 34, 37, 38, 39, 40, 41, 42, 43, 44, 45, 46, 47, 48, 49, 51, 53, 54, 55, 56, 57, 58, 59, 60, 61, 62, 63, 64, 65, 67, 68, 70, 71, 72, 73, 74, 75, 76, 77, 78, 79, 80, 81, 82, 83, 84, 85, 86, 87, 88, 89, 90, 91, 92, 93, 94, 95, 96, 97, 98, 100, 101, 102, 103, 104, 105, 106, 107, 108, 109, 110, 111, 112]"
reverse-interview,13481,17,11,6,"[1, 2, 3, 4, 11, 14, 20, 21, 29, 32, 34, 43, 55, 65, 66, 68, 69]"
WeChatPlugin-MacOS,13478,554,423,131,"[1, 2, 3, 4, 5, 6, 8, 9, 10, 11, 13, 14, 15, 16, 17, 18, 19, 20, 21, 22, 23, 24, 25, 26, 27, 28, 29, 30, 31, 33, 34, 35, 36, 37, 38, 39, 40, 41, 42, 43, 44, 45, 46, 47, 48, 49, 50, 51, 52, 53, 54, 55, 56, 57, 58, 59, 60, 61, 62, 63, 64, 65, 66, 67, 68, 69, 70, 71, 72, 73, 74, 75, 76, 77, 78, 79, 80, 81, 82, 83, 84, 85, 86, 87, 89, 90, 91, 92, 93, 94, 95, 96, 97, 98, 99, 100, 101, 102, 103, 104]"
react-dnd,13459,1231,1116,115,"[1, 2, 3, 4, 5, 8, 9, 10, 11, 12, 14, 15, 16, 17, 18, 20, 21, 22, 23, 26, 27, 28, 29, 30, 31, 32, 33, 34, 35, 38, 45, 47, 49, 54, 55, 58, 67, 69, 75, 77, 78, 80, 81, 82, 83, 87, 88, 89, 91, 93, 95, 96, 100, 101, 103, 104, 106, 107, 108, 109, 110, 112, 113, 116, 117, 119, 120, 121, 122, 123, 124, 125, 127, 128, 130, 132, 133, 135, 137, 138, 139, 142, 144, 147, 148, 149, 150, 151, 152, 155, 156, 157, 158, 160, 161, 162, 163, 164, 165, 166]"
docsify,13450,776,677,99,"[1, 2, 3, 4, 6, 7, 9, 10, 11, 13, 15, 17, 18, 19, 20, 22, 23, 24, 26, 29, 30, 31, 34, 35, 36, 37, 40, 41, 42, 43, 45, 46, 49, 51, 52, 54, 56, 59, 60, 61, 63, 67, 68, 70, 71, 78, 79, 80, 82, 86, 87, 88, 90, 94, 95, 96, 98, 99, 100, 101, 102, 103, 106, 107, 109, 110, 114, 116, 117, 119, 120, 123, 124, 125, 126, 128, 129, 130, 131, 134, 136, 137, 139, 140, 141, 142, 144, 146, 149, 150, 152, 153, 154, 155, 156, 157, 158, 159, 162, 165]"
amazeui,13435,700,564,136,"[1, 2, 4, 6, 7, 11, 12, 15, 16, 17, 19, 20, 24, 26, 27, 30, 33, 34, 35, 39, 42, 43, 53, 54, 55, 56, 57, 58, 59, 63, 64, 68, 69, 70, 72, 73, 74, 75, 76, 77, 78, 79, 89, 90, 94, 95, 96, 104, 111, 112, 113, 114, 116, 119, 120, 124, 129, 130, 131, 132, 134, 135, 144, 154, 155, 157, 162, 163, 164, 165, 169, 179, 181, 183, 188, 191, 193, 194, 195, 197, 198, 199, 200, 208, 210, 215, 217, 218, 223, 227, 236, 237, 238, 239, 240, 245, 247, 251, 253, 259]"
nerdtree,13428,761,751,10,"[1, 2, 3, 4, 5, 6, 7, 8, 9, 10, 11, 12, 13, 14, 15, 16, 17, 18, 19, 20, 21, 22, 23, 24, 25, 26, 27, 28, 29, 30, 31, 32, 33, 34, 35, 36, 37, 38, 40, 41, 43, 45, 46, 47, 48, 49, 53, 54, 57, 59, 60, 62, 63, 66, 67, 68, 69, 70, 71, 75, 76, 77, 81, 82, 83, 85, 90, 91, 92, 93, 94, 97, 98, 99, 100, 103, 105, 106, 107, 108, 109, 112, 113, 114, 116, 117, 118, 119, 120, 121, 123, 124, 125, 128, 129, 130, 131, 133, 134, 135]"
PySnooper,13422,96,81,15,"[1, 2, 5, 6, 7, 9, 10, 11, 14, 15, 16, 17, 18, 19, 20, 21, 23, 24, 25, 26, 27, 28, 30, 32, 34, 35, 36, 39, 41, 43, 44, 46, 48, 49, 57, 58, 59, 61, 63, 67, 69, 70, 73, 75, 78, 79, 80, 82, 83, 84, 88, 89, 92, 93, 94, 95, 98, 100, 101, 104, 109, 115, 120, 121, 124, 125, 127, 128, 132, 133, 134, 135, 136, 137, 138, 139, 141, 142, 143, 144, 146, 150, 152, 154, 158, 163, 164, 165, 167, 168, 173, 175, 176, 177, 180, 182]"
toml,13421,359,330,29,"[1, 2, 6, 8, 9, 10, 11, 13, 15, 17, 19, 20, 21, 22, 27, 28, 29, 30, 33, 36, 42, 43, 44, 48, 49, 50, 53, 54, 55, 58, 61, 63, 65, 72, 73, 76, 77, 80, 83, 90, 94, 102, 105, 107, 108, 111, 112, 119, 120, 126, 127, 128, 129, 131, 142, 145, 146, 158, 161, 162, 163, 165, 169, 175, 179, 180, 181, 185, 186, 187, 188, 190, 197, 201, 202, 204, 212, 213, 214, 216, 217, 218, 219, 220, 227, 229, 230, 233, 239, 243, 246, 247, 248, 249, 252, 253, 254, 255, 256, 259]"
rough,13420,95,85,10,"[3, 4, 13, 14, 15, 16, 18, 19, 20, 21, 22, 23, 24, 27, 28, 29, 30, 34, 35, 40, 41, 43, 44, 45, 47, 48, 51, 53, 54, 55, 57, 58, 59, 61, 62, 63, 65, 66, 67, 69, 70, 71, 74, 75, 79, 82, 85, 86, 89, 90, 91, 93, 94, 96, 97, 98, 99, 100, 101, 104, 105, 106, 107, 108, 109, 110, 111, 112, 114, 115, 116, 117, 118, 119, 120, 123, 127, 130, 131, 132, 133, 135, 136, 137, 139, 142, 143, 145, 147, 148, 151, 152, 153, 154, 156]"
electronic-wechat,13418,594,397,197,"[1, 2, 3, 5, 6, 7, 10, 11, 12, 19, 22, 23, 24, 29, 30, 31, 32, 33, 34, 35, 36, 37, 38, 39, 40, 42, 43, 44, 45, 46, 47, 48, 49, 51, 53, 54, 55, 56, 57, 58, 59, 60, 63, 65, 66, 67, 69, 71, 73, 74, 75, 77, 78, 79, 80, 81, 82, 83, 85, 86, 87, 88, 90, 92, 93, 94, 95, 96, 98, 99, 100, 101, 103, 104, 106, 107, 108, 109, 111, 113, 115, 116, 117, 118, 119, 120, 122, 123, 124, 125, 126, 127, 128, 129, 130, 131, 132, 133, 134, 135]"
data,13408,101,72,29,"[1, 2, 3, 4, 5, 8, 21, 23, 24, 25, 26, 27, 31, 32, 33, 37, 38, 42, 43, 45, 50, 51, 52, 55, 61, 62, 65, 66, 70, 72, 73, 78, 79, 81, 85, 87, 89, 91, 92, 93, 94, 95, 97, 99, 100, 101, 102, 104, 105, 107, 114, 120, 122, 125, 129, 173, 177, 179, 180, 184, 193, 194, 196, 198, 199, 200, 201, 202, 203, 207, 208, 209, 210, 211, 212, 214, 215, 216, 219, 220, 221, 224, 225, 226, 228, 229, 230, 231, 232, 234, 236, 238, 239, 240, 241, 242, 245, 246, 247, 249]"
Awesome,13400,68,63,5,"[1, 2, 4, 5, 13, 21, 42, 45, 49, 52, 53, 59, 62, 64, 68, 69, 77, 80, 82, 107, 109, 135, 149, 153, 154, 167, 169, 170, 174, 176, 181, 185, 224, 229, 230, 231, 233, 236, 239, 253, 257, 268, 271, 274, 279, 286, 295, 298, 299, 300, 301, 302, 303, 304, 305, 306, 307, 308, 309, 310, 311, 315, 323, 324, 325, 326, 331, 333]"
mybatis-3,13388,988,878,110,"[1, 2, 3, 4, 5, 6, 7, 8, 9, 10, 11, 12, 13, 14, 17, 18, 21, 23, 24, 25, 26, 28, 29, 31, 32, 33, 34, 35, 36, 37, 38, 39, 40, 41, 42, 43, 44, 45, 46, 47, 49, 50, 51, 53, 54, 55, 56, 57, 58, 60, 61, 62, 63, 64, 65, 66, 67, 68, 69, 70, 72, 75, 76, 77, 78, 79, 80, 81, 82, 83, 85, 86, 87, 88, 89, 90, 91, 92, 93, 94, 95, 96, 97, 98, 99, 100, 101, 102, 103, 104, 105, 106, 107, 108, 109, 110, 111, 112, 113, 114]"
fastapi,13384,964,791,173,"[2, 3, 4, 5, 6, 7, 8, 9, 10, 12, 13, 14, 15, 16, 18, 19, 22, 23, 27, 28, 31, 33, 36, 38, 39, 43, 46, 47, 49, 50, 51, 54, 56, 57, 58, 59, 60, 66, 67, 68, 69, 70, 71, 78, 79, 80, 81, 82, 83, 84, 85, 86, 87, 93, 94, 96, 98, 101, 102, 104, 106, 110, 111, 114, 115, 119, 120, 122, 124, 125, 129, 130, 131, 132, 133, 135, 136, 137, 139, 142, 143, 144, 146, 147, 149, 152, 153, 154, 161, 162, 165, 166, 167, 171, 172, 179, 180, 181, 182, 190]"
cayley,13363,459,389,70,"[2, 3, 5, 6, 7, 9, 10, 14, 20, 21, 23, 24, 25, 30, 34, 35, 38, 39, 42, 45, 49, 53, 54, 57, 58, 60, 61, 63, 64, 66, 67, 68, 70, 72, 73, 74, 78, 81, 86, 91, 94, 95, 97, 102, 106, 107, 110, 111, 112, 114, 115, 117, 121, 123, 124, 129, 130, 133, 134, 140, 144, 147, 150, 154, 155, 156, 157, 160, 163, 164, 165, 168, 169, 170, 171, 172, 173, 175, 176, 177, 178, 181, 183, 185, 187, 191, 193, 196, 197, 198, 200, 201, 205, 209, 211, 213, 215, 220, 221, 222]"
yii2,13355,10618,10155,463,"[1, 2, 3, 4, 5, 6, 7, 8, 9, 10, 11, 12, 13, 14, 15, 16, 17, 18, 19, 20, 21, 22, 23, 24, 25, 26, 27, 28, 29, 30, 31, 32, 33, 34, 35, 36, 37, 38, 39, 40, 41, 42, 43, 44, 45, 46, 47, 48, 49, 50, 51, 52, 53, 54, 55, 56, 57, 58, 59, 60, 61, 62, 63, 64, 65, 66, 67, 68, 69, 70, 71, 72, 73, 74, 75, 76, 77, 78, 80, 82, 83, 84, 85, 87, 90, 92, 95, 96, 99, 100, 102, 105, 107, 108, 109, 110, 111, 113, 118, 119]"
insomnia,13346,1610,1294,316,"[1, 2, 3, 4, 8, 9, 10, 11, 13, 17, 18, 20, 21, 22, 23, 24, 44, 45, 46, 50, 51, 52, 53, 54, 55, 56, 57, 58, 60, 61, 62, 63, 64, 65, 67, 68, 69, 137, 138, 142, 144, 145, 146, 149, 150, 151, 152, 153, 154, 162, 166, 168, 170, 173, 174, 175, 176, 177, 178, 179, 180, 182, 183, 184, 186, 187, 188, 189, 190, 191, 192, 194, 195, 196, 197, 201, 203, 205, 206, 208, 209, 210, 212, 215, 217, 218, 219, 222, 223, 226, 227, 228, 229, 230, 231, 232, 233, 235, 238, 239]"
You-Dont-Need-JavaScript,13345,34,9,25,"[2, 3, 4, 6, 7, 8, 10, 11, 12, 14, 15, 16, 17, 18, 19, 20, 22, 25, 27, 29, 34, 37, 45, 52, 60, 61, 65, 70, 72, 74, 75, 76, 77, 82]"
angular-seed,13339,213,204,9,"[1, 2, 13, 14, 16, 19, 21, 25, 26, 29, 30, 37, 40, 42, 44, 47, 48, 49, 51, 54, 56, 60, 62, 67, 68, 71, 72, 78, 80, 81, 82, 83, 84, 86, 89, 92, 100, 102, 103, 109, 110, 115, 116, 118, 133, 136, 139, 143, 146, 147, 153, 154, 156, 158, 159, 161, 168, 169, 170, 171, 176, 179, 180, 185, 188, 189, 191, 193, 196, 198, 199, 200, 201, 203, 204, 208, 211, 212, 215, 216, 217, 218, 219, 220, 222, 226, 227, 230, 231, 233, 234, 236, 239, 241, 243, 245, 248, 250, 251, 253]"
SwiftLint,13334,1629,1278,351,"[1, 3, 4, 5, 6, 8, 10, 13, 15, 16, 17, 18, 20, 21, 23, 25, 26, 27, 28, 29, 30, 32, 36, 38, 40, 42, 43, 45, 49, 50, 51, 52, 53, 54, 55, 56, 57, 58, 59, 60, 62, 66, 67, 68, 69, 70, 71, 72, 73, 74, 77, 78, 80, 81, 84, 85, 88, 89, 90, 92, 93, 95, 101, 102, 104, 108, 109, 112, 113, 120, 123, 125, 129, 130, 131, 132, 134, 135, 136, 137, 138, 139, 143, 145, 146, 147, 148, 149, 150, 151, 153, 154, 156, 158, 159, 160, 161, 162, 166, 169]"
Hack,13323,429,333,96,"[1, 3, 4, 5, 6, 7, 8, 9, 10, 11, 12, 13, 14, 15, 16, 17, 18, 19, 20, 21, 22, 23, 24, 25, 26, 27, 28, 29, 30, 31, 32, 33, 34, 35, 36, 37, 38, 39, 40, 41, 42, 43, 44, 45, 46, 47, 48, 49, 50, 51, 52, 53, 54, 55, 56, 57, 58, 59, 60, 61, 62, 63, 64, 65, 66, 67, 69, 70, 71, 72, 73, 74, 75, 76, 77, 78, 80, 81, 82, 83, 84, 85, 86, 87, 88, 89, 90, 91, 92, 93, 94, 95, 96, 97, 98, 99, 100, 101, 102, 103]"
bokeh,13319,5883,5371,512,"[2, 3, 4, 5, 6, 7, 8, 10, 11, 12, 14, 15, 17, 18, 19, 22, 23, 24, 26, 28, 29, 30, 31, 32, 35, 37, 39, 43, 45, 46, 47, 48, 49, 50, 51, 53, 54, 55, 56, 57, 58, 59, 60, 61, 62, 63, 64, 65, 66, 67, 68, 69, 70, 71, 72, 73, 74, 75, 76, 77, 78, 79, 80, 81, 82, 83, 84, 85, 86, 87, 88, 89, 90, 91, 92, 93, 94, 95, 97, 98, 99, 100, 101, 102, 103, 105, 106, 107, 108, 109, 110, 111, 113, 114, 115, 116, 117, 118, 119, 120]"
fd,13319,352,331,21,"[1, 2, 3, 4, 5, 6, 7, 8, 9, 10, 11, 12, 13, 14, 15, 16, 17, 18, 19, 20, 21, 22, 23, 24, 25, 26, 27, 28, 29, 30, 31, 32, 33, 34, 36, 37, 39, 40, 42, 43, 44, 45, 46, 48, 49, 52, 54, 56, 57, 63, 64, 65, 69, 70, 73, 76, 77, 79, 80, 81, 82, 84, 85, 86, 87, 88, 89, 91, 92, 93, 94, 97, 99, 103, 104, 105, 106, 107, 108, 111, 121, 127, 129, 132, 134, 135, 138, 141, 153, 154, 155, 156, 157, 159, 162, 164, 165, 166, 168, 170]"
AsyncDisplayKit,13318,1365,1343,22,"[3, 5, 7, 8, 10, 11, 15, 19, 20, 27, 28, 29, 30, 31, 32, 33, 34, 35, 37, 38, 40, 42, 49, 51, 54, 56, 57, 58, 59, 60, 62, 63, 64, 65, 66, 67, 68, 69, 70, 72, 73, 74, 76, 77, 78, 79, 80, 81, 86, 88, 89, 90, 91, 93, 94, 95, 96, 97, 98, 99, 100, 104, 107, 108, 112, 114, 115, 121, 123, 124, 125, 126, 131, 132, 133, 134, 136, 137, 138, 142, 148, 149, 152, 154, 155, 156, 157, 158, 159, 160, 161, 163, 166, 170, 173, 174, 175, 176, 178, 179]"
http-api-design,13314,46,17,29,"[3, 5, 8, 9, 12, 13, 14, 15, 17, 18, 19, 21, 25, 26, 32, 33, 34, 35, 36, 39, 45, 46, 47, 49, 52, 53, 56, 57, 58, 59, 60, 61, 62, 66, 68, 69, 70, 72, 75, 79, 81, 87, 91, 93, 94, 97]"
fmdb,13308,525,309,216,"[2, 3, 6, 8, 10, 12, 15, 16, 17, 18, 21, 22, 23, 24, 25, 26, 27, 29, 31, 32, 33, 34, 35, 36, 38, 39, 41, 42, 43, 44, 45, 46, 47, 48, 49, 50, 51, 52, 53, 54, 55, 56, 57, 59, 61, 63, 64, 65, 66, 67, 71, 72, 73, 74, 75, 76, 78, 79, 80, 81, 83, 84, 85, 87, 88, 90, 91, 92, 94, 95, 96, 97, 98, 100, 101, 102, 103, 104, 106, 111, 112, 113, 115, 118, 119, 120, 123, 128, 131, 132, 133, 136, 137, 138, 139, 140, 144, 145, 147, 148]"
openface,13304,366,364,2,"[1, 2, 3, 4, 5, 6, 7, 8, 10, 11, 12, 13, 14, 15, 16, 17, 19, 20, 21, 22, 23, 24, 25, 26, 27, 28, 29, 30, 31, 32, 33, 34, 35, 36, 37, 39, 40, 41, 42, 43, 46, 47, 48, 49, 50, 51, 52, 53, 54, 55, 56, 57, 58, 59, 60, 63, 65, 66, 67, 69, 70, 71, 72, 73, 74, 75, 76, 77, 78, 79, 80, 81, 82, 83, 84, 85, 86, 87, 88, 89, 90, 91, 92, 93, 94, 95, 96, 97, 99, 100, 101, 102, 103, 104, 105, 106, 109, 111, 112, 113]"
lazysizes,13297,671,543,128,"[1, 2, 3, 7, 8, 9, 10, 11, 12, 13, 15, 16, 17, 18, 19, 21, 22, 23, 26, 27, 28, 29, 30, 33, 34, 35, 36, 37, 39, 40, 41, 42, 43, 44, 45, 46, 47, 50, 51, 52, 53, 54, 55, 56, 57, 58, 59, 60, 64, 65, 66, 67, 68, 69, 70, 71, 72, 73, 74, 75, 76, 77, 78, 79, 80, 81, 82, 83, 84, 85, 86, 87, 88, 90, 91, 92, 94, 95, 96, 97, 98, 100, 101, 102, 103, 105, 106, 107, 108, 109, 110, 111, 112, 113, 117, 118, 119, 120, 121, 122]"
dbeaver,13287,7901,6595,1306,"[1, 2, 3, 4, 5, 6, 7, 8, 9, 10, 11, 12, 13, 14, 16, 17, 18, 19, 21, 22, 23, 24, 25, 26, 27, 28, 29, 30, 31, 32, 33, 34, 35, 36, 37, 38, 39, 40, 41, 42, 43, 44, 45, 46, 47, 48, 49, 50, 51, 52, 53, 54, 55, 56, 57, 58, 59, 60, 61, 62, 63, 64, 65, 66, 67, 68, 69, 70, 71, 72, 73, 74, 75, 76, 77, 78, 79, 80, 81, 82, 83, 84, 85, 86, 87, 88, 89, 90, 91, 92, 93, 94, 95, 96, 97, 98, 99, 100, 101, 102]"
react-native-vector-icons,13285,929,693,236,"[1, 2, 3, 4, 5, 6, 7, 8, 9, 10, 11, 12, 13, 14, 16, 17, 19, 21, 23, 24, 25, 27, 28, 29, 30, 31, 32, 33, 36, 39, 40, 41, 42, 43, 44, 45, 46, 47, 48, 49, 50, 51, 52, 54, 55, 57, 58, 59, 60, 61, 62, 63, 64, 65, 66, 67, 70, 73, 74, 75, 76, 77, 78, 79, 80, 81, 82, 83, 84, 85, 86, 87, 88, 89, 90, 94, 95, 98, 99, 100, 101, 102, 103, 104, 105, 106, 107, 108, 111, 112, 113, 114, 115, 117, 118, 119, 120, 121, 123, 124]"
Material-Animations,13281,40,27,13,"[2, 3, 5, 6, 7, 8, 9, 10, 11, 12, 16, 17, 24, 26, 29, 31, 32, 36, 39, 40, 41, 42, 43, 44, 45, 46, 47, 48, 49, 50, 51, 52, 53, 54, 55, 57, 59, 60, 61, 64]"
cheatsheets-ai,13278,14,8,6,"[1, 2, 4, 5, 6, 7, 80, 83, 86, 87, 89, 90, 91, 93]"
diff-so-fancy,13272,211,202,9,"[3, 4, 5, 6, 7, 9, 12, 14, 15, 16, 17, 18, 21, 22, 26, 28, 32, 35, 40, 41, 42, 43, 45, 46, 48, 49, 57, 58, 66, 68, 69, 70, 71, 72, 73, 78, 79, 80, 81, 82, 84, 85, 86, 88, 89, 93, 94, 96, 97, 98, 99, 100, 101, 103, 109, 112, 113, 114, 118, 119, 120, 124, 126, 127, 129, 133, 137, 140, 145, 148, 149, 150, 151, 155, 157, 159, 162, 164, 165, 166, 173, 174, 175, 176, 178, 181, 182, 183, 184, 186, 187, 194, 195, 196, 197, 198, 199, 200, 201, 202]"
chromeless,13267,332,160,172,"[1, 2, 3, 4, 5, 6, 7, 9, 10, 11, 12, 13, 14, 15, 16, 17, 18, 19, 21, 22, 23, 24, 25, 26, 27, 28, 29, 30, 31, 32, 33, 34, 35, 36, 37, 38, 39, 40, 41, 43, 44, 45, 46, 47, 48, 49, 50, 51, 52, 53, 54, 55, 56, 58, 61, 62, 63, 65, 67, 68, 69, 70, 71, 73, 74, 75, 76, 77, 78, 79, 80, 81, 82, 83, 85, 86, 87, 88, 89, 90, 91, 92, 93, 94, 98, 99, 100, 105, 107, 108, 111, 113, 114, 119, 121, 124, 125, 126, 127, 129]"
luigi,13262,836,797,39,"[1, 3, 4, 11, 12, 13, 14, 18, 24, 28, 29, 46, 51, 59, 60, 63, 66, 77, 94, 96, 98, 99, 100, 101, 113, 114, 122, 130, 137, 138, 141, 150, 154, 161, 167, 173, 183, 188, 192, 193, 197, 199, 201, 206, 211, 212, 213, 215, 216, 222, 226, 232, 256, 265, 266, 267, 285, 286, 289, 294, 302, 311, 315, 328, 331, 333, 341, 345, 347, 350, 357, 360, 366, 367, 372, 380, 382, 390, 391, 412, 420, 426, 430, 434, 435, 436, 443, 449, 451, 459, 466, 468, 498, 502, 506, 511, 514, 519, 520, 521]"
fonts,13261,1256,583,673,"[2, 3, 4, 6, 7, 8, 9, 10, 11, 12, 13, 14, 15, 16, 17, 18, 20, 21, 22, 23, 24, 25, 26, 27, 28, 30, 33, 36, 39, 40, 41, 42, 45, 46, 47, 51, 52, 56, 58, 60, 61, 62, 63, 64, 65, 66, 67, 68, 69, 70, 71, 72, 73, 75, 76, 77, 78, 79, 80, 81, 82, 83, 85, 86, 87, 88, 89, 91, 93, 94, 95, 96, 97, 100, 101, 102, 103, 104, 105, 106, 107, 109, 110, 111, 112, 113, 114, 115, 116, 117, 118, 119, 120, 121, 123, 124, 125, 126, 127, 128]"
charts,13260,189,98,91,"[2, 3, 4, 5, 6, 7, 8, 12, 13, 18, 20, 23, 24, 26, 29, 30, 31, 32, 34, 36, 37, 38, 39, 40, 41, 42, 43, 44, 47, 48, 49, 50, 51, 54, 55, 56, 57, 63, 64, 65, 67, 70, 72, 73, 74, 76, 77, 78, 79, 80, 81, 82, 83, 84, 85, 86, 87, 88, 92, 93, 95, 96, 97, 98, 100, 101, 102, 106, 107, 108, 110, 111, 112, 113, 114, 115, 116, 117, 118, 121, 122, 123, 124, 125, 127, 128, 130, 131, 132, 133, 134, 135, 136, 138, 139, 140, 143, 144, 147, 148]"
leetcode,13251,50,34,16,"[1, 4, 7, 9, 11, 13, 15, 16, 18, 19, 22, 25, 27, 32, 36, 41, 42, 44, 45, 50, 65, 67, 80, 87, 96, 100, 102, 104, 120, 124, 127, 131, 132, 135, 138, 143, 144, 147, 149, 156, 160, 165, 167, 174, 179, 182, 186, 190, 196, 200]"
spring-cloud-alibaba,13244,902,679,223,"[1, 2, 3, 4, 5, 6, 8, 9, 10, 11, 12, 13, 14, 15, 16, 17, 18, 19, 22, 23, 26, 27, 28, 31, 32, 34, 37, 38, 39, 40, 41, 42, 43, 48, 49, 50, 51, 52, 58, 61, 62, 63, 64, 65, 66, 68, 71, 79, 85, 86, 87, 90, 91, 98, 99, 100, 102, 103, 105, 110, 111, 113, 114, 115, 116, 120, 121, 122, 125, 130, 131, 132, 133, 134, 138, 141, 144, 145, 146, 147, 149, 150, 151, 154, 156, 159, 160, 161, 162, 163, 166, 167, 183, 184, 186, 198, 204, 205, 206, 209]"
bitcoinbook,13240,263,207,56,"[10, 15, 17, 18, 19, 20, 21, 22, 23, 24, 25, 26, 28, 30, 31, 32, 34, 38, 39, 40, 41, 43, 45, 46, 47, 48, 54, 55, 57, 58, 63, 71, 72, 75, 76, 80, 81, 82, 85, 86, 87, 92, 93, 94, 95, 100, 108, 112, 118, 120, 121, 122, 123, 131, 133, 135, 136, 138, 139, 140, 142, 145, 148, 149, 155, 156, 157, 158, 159, 160, 189, 193, 195, 196, 199, 205, 206, 212, 215, 228, 243, 251, 252, 253, 254, 255, 256, 257, 258, 259, 260, 261, 262, 263, 268, 270, 281, 289, 290, 294]"
Qix,13225,20,20,0,"[1, 2, 3, 4, 5, 10, 11, 13, 14, 15, 16, 21, 22, 23, 25, 29, 33, 34, 37, 38]"
cat,13223,991,943,48,"[3, 4, 5, 6, 7, 28, 141, 172, 176, 177, 178, 179, 180, 181, 182, 183, 192, 201, 202, 203, 212, 213, 214, 215, 216, 217, 218, 219, 220, 221, 222, 223, 224, 225, 227, 228, 229, 230, 236, 237, 254, 267, 268, 279, 282, 381, 383, 384, 389, 416, 418, 485, 574, 589, 610, 633, 638, 643, 685, 695, 697, 698, 699, 709, 712, 714, 717, 718, 721, 722, 723, 724, 727, 728, 731, 733, 738, 739, 740, 741, 742, 744, 745, 749, 750, 751, 752, 753, 754, 757, 758, 759, 760, 761, 765, 766, 770, 771, 772, 773]"
nuklear,13219,659,451,208,"[2, 3, 4, 5, 6, 7, 8, 9, 10, 12, 13, 14, 15, 16, 17, 18, 19, 20, 22, 23, 26, 27, 28, 29, 30, 31, 32, 33, 34, 35, 36, 37, 38, 39, 40, 41, 47, 48, 49, 50, 51, 52, 53, 54, 55, 56, 57, 58, 59, 63, 64, 65, 68, 69, 70, 74, 77, 78, 79, 83, 84, 86, 87, 88, 89, 90, 92, 94, 95, 97, 99, 101, 105, 106, 107, 108, 111, 115, 116, 117, 118, 119, 121, 122, 123, 124, 127, 131, 132, 133, 134, 135, 136, 137, 138, 139, 140, 141, 142, 143]"
skywalking,13214,2280,2188,92,"[1, 2, 3, 4, 5, 6, 7, 8, 9, 10, 11, 12, 13, 14, 15, 16, 17, 18, 19, 20, 21, 22, 23, 24, 25, 26, 27, 28, 29, 30, 31, 32, 33, 34, 35, 36, 37, 38, 39, 41, 42, 43, 44, 45, 47, 48, 49, 50, 51, 53, 54, 56, 57, 58, 59, 60, 61, 62, 63, 64, 67, 68, 69, 71, 72, 73, 74, 75, 76, 77, 78, 79, 80, 82, 83, 84, 88, 99, 100, 103, 104, 110, 111, 112, 113, 114, 115, 116, 117, 118, 123, 124, 125, 126, 129, 131, 134, 135, 136, 138]"
zsh-autosuggestions,13211,377,348,29,"[1, 2, 3, 4, 5, 6, 7, 8, 9, 10, 12, 13, 14, 15, 18, 19, 22, 23, 24, 25, 26, 27, 28, 29, 30, 33, 36, 37, 38, 39, 42, 43, 44, 46, 47, 48, 50, 52, 54, 62, 64, 66, 67, 69, 70, 71, 72, 73, 75, 77, 78, 79, 80, 81, 82, 84, 86, 88, 90, 92, 93, 94, 95, 96, 97, 98, 99, 100, 101, 102, 103, 104, 105, 106, 107, 108, 109, 110, 111, 112, 113, 114, 115, 116, 117, 118, 119, 120, 121, 123, 126, 127, 128, 130, 132, 133, 135, 136, 137, 138]"
rxdb,13194,368,365,3,"[2, 4, 6, 7, 8, 11, 13, 14, 15, 17, 19, 20, 21, 22, 28, 29, 30, 31, 32, 34, 36, 39, 40, 41, 42, 43, 44, 45, 46, 47, 48, 49, 50, 52, 58, 59, 60, 61, 64, 66, 67, 68, 69, 71, 72, 74, 75, 76, 77, 86, 87, 88, 95, 113, 116, 118, 120, 121, 123, 124, 126, 128, 132, 133, 134, 135, 136, 138, 139, 140, 141, 142, 143, 144, 145, 146, 149, 150, 151, 154, 157, 158, 159, 160, 161, 163, 164, 165, 168, 170, 171, 172, 174, 175, 179, 180, 181, 182, 190, 191]"
browserify,13182,1414,1098,316,"[2, 3, 4, 6, 7, 8, 10, 11, 12, 13, 15, 18, 21, 22, 23, 24, 25, 27, 29, 31, 33, 34, 36, 39, 40, 41, 46, 47, 48, 49, 50, 51, 54, 56, 57, 58, 59, 60, 61, 62, 67, 70, 72, 73, 75, 76, 80, 83, 84, 87, 88, 89, 90, 91, 92, 93, 95, 96, 97, 98, 100, 101, 102, 105, 106, 107, 108, 109, 110, 112, 113, 114, 115, 116, 117, 118, 119, 120, 121, 122, 125, 129, 130, 132, 133, 135, 138, 139, 140, 142, 146, 147, 148, 156, 157, 161, 165, 166, 167, 168]"
dep,13181,1349,1086,263,"[10, 15, 19, 20, 21, 22, 23, 25, 26, 30, 35, 36, 38, 39, 40, 41, 42, 47, 50, 52, 57, 59, 61, 62, 63, 64, 65, 66, 67, 68, 69, 70, 71, 72, 73, 74, 77, 82, 83, 88, 90, 91, 93, 100, 101, 103, 109, 110, 114, 115, 116, 119, 120, 121, 125, 126, 128, 129, 131, 133, 136, 138, 139, 144, 145, 148, 149, 151, 154, 158, 159, 160, 161, 162, 165, 166, 168, 169, 170, 171, 174, 175, 176, 183, 185, 186, 191, 193, 198, 201, 202, 204, 206, 207, 208, 209, 211, 213, 214, 216]"
MJRefresh,13172,1243,1218,25,"[1, 2, 5, 6, 7, 8, 9, 10, 11, 12, 14, 15, 17, 18, 19, 20, 21, 22, 23, 24, 25, 26, 27, 28, 29, 30, 31, 32, 33, 34, 35, 36, 37, 38, 39, 40, 41, 42, 43, 44, 45, 46, 47, 48, 49, 50, 51, 52, 53, 54, 55, 56, 57, 60, 61, 63, 66, 68, 70, 71, 72, 74, 75, 76, 77, 78, 79, 80, 81, 82, 83, 84, 85, 86, 88, 89, 90, 91, 92, 93, 94, 95, 96, 97, 98, 99, 100, 101, 102, 103, 104, 105, 106, 108, 109, 110, 111, 112, 115, 117]"
vimium,13165,2601,1924,677,"[1, 2, 3, 4, 5, 6, 7, 8, 9, 10, 11, 12, 13, 14, 15, 16, 17, 18, 19, 20, 21, 22, 23, 24, 25, 26, 27, 28, 29, 30, 31, 32, 33, 34, 35, 36, 37, 38, 39, 40, 41, 42, 43, 44, 45, 46, 47, 48, 49, 50, 51, 52, 53, 54, 55, 56, 57, 58, 59, 60, 61, 62, 63, 64, 65, 66, 67, 68, 69, 70, 71, 72, 73, 74, 75, 76, 77, 78, 79, 80, 81, 82, 83, 84, 85, 86, 87, 88, 89, 90, 91, 92, 93, 94, 95, 96, 97, 98, 99, 100]"
best-resume-ever,13163,113,92,21,"[1, 2, 3, 4, 7, 8, 9, 12, 13, 15, 16, 17, 18, 19, 20, 21, 23, 24, 26, 28, 31, 32, 33, 35, 36, 37, 39, 41, 44, 46, 47, 48, 51, 52, 54, 58, 65, 66, 70, 71, 73, 77, 78, 85, 86, 93, 95, 98, 100, 101, 104, 109, 110, 115, 118, 123, 129, 131, 132, 136, 137, 139, 151, 153, 157, 160, 161, 162, 167, 172, 187, 188, 190, 197, 206, 210, 214, 261, 274, 291, 292, 293, 295, 305, 306, 309, 310, 311, 312, 313, 316, 320, 323, 324, 326, 328, 329, 330, 333, 334]"
spring-boot-demo,13163,83,52,31,"[1, 3, 5, 6, 7, 8, 9, 10, 11, 12, 13, 15, 17, 19, 20, 21, 22, 23, 24, 25, 26, 27, 29, 31, 32, 36, 37, 38, 39, 41, 42, 43, 44, 45, 46, 47, 48, 52, 53, 54, 55, 56, 57, 58, 60, 61, 62, 63, 64, 65, 66, 67, 68, 69, 70, 71, 72, 73, 75, 78, 81, 82, 83, 85, 87, 88, 90, 91, 96, 97, 99, 100, 106, 108, 111, 112, 115, 116, 118, 121, 122, 123, 126]"
WebViewJavascriptBridge,13160,263,197,66,"[1, 3, 6, 8, 10, 11, 12, 13, 16, 18, 24, 25, 27, 28, 29, 30, 31, 32, 33, 34, 38, 39, 40, 41, 45, 47, 48, 49, 51, 52, 54, 56, 58, 60, 61, 62, 63, 64, 65, 69, 71, 72, 74, 79, 81, 82, 83, 84, 85, 86, 87, 88, 90, 91, 94, 95, 96, 98, 99, 100, 101, 102, 103, 104, 108, 109, 110, 111, 113, 115, 118, 119, 120, 121, 123, 124, 125, 126, 130, 131, 132, 134, 135, 136, 137, 141, 144, 147, 148, 149, 151, 152, 153, 154, 155, 156, 158, 159, 160, 161]"
tfjs,13160,2079,1643,436,"[8, 9, 10, 13, 15, 16, 19, 20, 21, 22, 23, 24, 25, 26, 27, 28, 29, 34, 36, 37, 38, 41, 42, 43, 44, 45, 46, 47, 50, 51, 52, 53, 54, 55, 56, 57, 58, 59, 60, 61, 62, 63, 64, 65, 66, 67, 68, 69, 70, 71, 72, 73, 74, 75, 76, 77, 78, 79, 80, 81, 82, 83, 84, 85, 86, 87, 89, 90, 91, 93, 94, 95, 96, 97, 98, 99, 100, 101, 102, 103, 104, 105, 106, 107, 108, 109, 110, 111, 112, 113, 114, 115, 116, 117, 118, 120, 121, 122, 123, 124]"
wiki,13155,321,303,18,"[1, 2, 3, 5, 6, 7, 8, 9, 10, 11, 12, 13, 14, 15, 16, 17, 18, 19, 20, 21, 22, 23, 24, 25, 26, 27, 28, 29, 32, 35, 36, 39, 40, 41, 42, 43, 45, 46, 47, 48, 49, 50, 51, 52, 54, 55, 56, 57, 58, 59, 61, 62, 63, 64, 65, 66, 67, 71, 72, 73, 75, 76, 77, 78, 79, 80, 81, 82, 83, 84, 85, 86, 87, 88, 90, 91, 92, 93, 94, 96, 97, 99, 101, 102, 104, 105, 106, 107, 108, 109, 110, 111, 112, 113, 114, 115, 116, 118, 119, 120]"
ink,13151,157,118,39,"[1, 2, 5, 10, 11, 13, 15, 16, 17, 18, 19, 20, 21, 22, 25, 26, 28, 30, 31, 32, 33, 34, 35, 37, 39, 40, 43, 45, 46, 47, 48, 51, 52, 54, 56, 57, 61, 63, 65, 74, 76, 77, 78, 79, 80, 82, 83, 84, 85, 86, 88, 90, 91, 92, 94, 95, 97, 99, 100, 103, 106, 108, 109, 110, 114, 115, 116, 119, 122, 123, 125, 126, 127, 130, 131, 132, 133, 135, 137, 138, 139, 142, 143, 144, 145, 150, 151, 152, 153, 154, 155, 156, 157, 158, 159, 160, 162, 163, 164, 166]"
loopback,13122,3251,3242,9,"[1, 7, 9, 14, 21, 78, 79, 80, 82, 89, 98, 103, 104, 109, 110, 111, 114, 115, 116, 117, 118, 120, 125, 126, 128, 131, 134, 140, 142, 144, 145, 147, 148, 149, 152, 155, 156, 157, 159, 160, 161, 162, 165, 169, 171, 174, 175, 177, 182, 183, 188, 189, 190, 191, 194, 198, 199, 200, 201, 203, 204, 205, 206, 207, 208, 209, 210, 211, 213, 218, 221, 222, 225, 226, 228, 229, 230, 231, 233, 235, 236, 237, 238, 239, 240, 241, 243, 245, 248, 250, 251, 255, 256, 257, 259, 260, 262, 265, 269, 270]"
yoga,13119,460,262,198,"[24, 25, 27, 29, 32, 36, 38, 39, 46, 47, 48, 51, 52, 53, 54, 55, 56, 57, 58, 61, 62, 63, 64, 71, 73, 78, 83, 93, 97, 98, 100, 101, 102, 103, 104, 107, 111, 114, 115, 120, 127, 128, 130, 132, 133, 142, 143, 147, 149, 152, 155, 156, 158, 160, 164, 165, 167, 168, 169, 173, 175, 176, 177, 179, 180, 181, 183, 184, 188, 189, 190, 197, 198, 201, 208, 209, 210, 213, 215, 216, 219, 222, 227, 228, 229, 230, 232, 234, 235, 236, 238, 240, 241, 242, 243, 244, 245, 247, 248, 250]"
micro,13115,1157,865,292,"[1, 2, 3, 4, 5, 6, 7, 8, 9, 10, 11, 12, 13, 16, 17, 18, 19, 20, 21, 22, 23, 24, 25, 26, 27, 28, 29, 31, 33, 34, 35, 36, 37, 39, 40, 43, 45, 46, 47, 48, 49, 50, 51, 53, 54, 56, 59, 60, 61, 63, 65, 69, 72, 73, 75, 76, 77, 78, 80, 81, 84, 85, 86, 88, 89, 90, 92, 93, 95, 98, 99, 100, 103, 104, 105, 106, 107, 109, 113, 116, 118, 119, 122, 124, 126, 128, 129, 131, 132, 134, 136, 138, 140, 141, 142, 143, 144, 145, 146, 147]"
react-helmet,13114,320,202,118,"[1, 3, 7, 17, 18, 19, 22, 23, 25, 26, 27, 30, 33, 34, 41, 42, 45, 46, 50, 51, 60, 61, 65, 66, 67, 70, 75, 76, 77, 78, 79, 80, 81, 84, 85, 86, 87, 88, 95, 96, 98, 100, 102, 103, 104, 105, 106, 107, 109, 110, 111, 112, 113, 115, 121, 123, 124, 125, 128, 129, 130, 132, 136, 138, 141, 142, 143, 144, 146, 147, 148, 149, 150, 151, 152, 153, 156, 157, 158, 159, 160, 161, 162, 163, 164, 168, 170, 172, 173, 177, 178, 180, 181, 182, 183, 184, 187, 189, 190, 193]"
eng-practices,13112,4,1,3,"[17, 21, 22, 25]"
dgraph,13105,2159,1912,247,"[1, 3, 4, 5, 6, 7, 8, 9, 10, 11, 12, 13, 14, 15, 18, 20, 21, 22, 23, 24, 32, 34, 35, 46, 47, 49, 51, 53, 54, 58, 59, 61, 62, 63, 64, 65, 71, 72, 75, 78, 83, 93, 96, 97, 98, 99, 100, 101, 102, 110, 111, 112, 114, 117, 118, 120, 123, 124, 125, 130, 131, 132, 133, 135, 136, 142, 144, 164, 186, 193, 232, 235, 265, 274, 282, 290, 294, 298, 309, 327, 337, 338, 339, 345, 347, 349, 351, 352, 353, 354, 355, 356, 358, 359, 360, 361, 362, 363, 364, 365]"
n,13086,404,400,4,"[1, 4, 5, 6, 7, 8, 9, 11, 12, 14, 15, 16, 20, 21, 24, 25, 26, 29, 30, 31, 32, 34, 37, 38, 39, 41, 42, 45, 46, 47, 48, 50, 51, 55, 58, 59, 61, 62, 63, 64, 68, 70, 71, 73, 75, 78, 79, 81, 82, 84, 86, 87, 89, 90, 92, 94, 95, 96, 99, 100, 101, 102, 103, 105, 106, 107, 108, 109, 111, 112, 113, 115, 116, 117, 118, 119, 123, 124, 127, 129, 130, 131, 132, 134, 139, 140, 144, 145, 146, 147, 149, 150, 151, 152, 154, 156, 158, 160, 161, 165]"
stream-handbook,13064,46,11,35,"[2, 3, 4, 6, 7, 8, 11, 14, 16, 18, 21, 22, 25, 29, 32, 35, 37, 39, 43, 46, 47, 48, 50, 51, 54, 56, 57, 62, 65, 69, 70, 73, 82, 83, 85, 86, 88, 90, 95, 99, 100, 102, 104, 108, 110, 111]"
matomo,13055,10869,9166,1703,"[2, 3, 5, 10, 306, 309, 311, 313, 315, 321, 326, 327, 329, 335, 338, 341, 342, 343, 380, 381, 382, 383, 384, 385, 386, 387, 388, 389, 390, 391, 392, 393, 394, 395, 396, 397, 398, 399, 400, 401, 402, 403, 404, 405, 406, 407, 408, 409, 410, 411, 412, 413, 414, 415, 416, 417, 418, 419, 420, 421, 422, 423, 424, 425, 426, 427, 428, 429, 430, 431, 432, 433, 434, 435, 436, 437, 438, 439, 440, 441, 442, 443, 444, 445, 446, 447, 448, 449, 450, 451, 452, 453, 454, 455, 456, 457, 458, 459, 460, 461]"
nginx-proxy,13053,1046,539,507,"[1, 3, 4, 5, 6, 8, 14, 16, 17, 18, 24, 25, 27, 29, 33, 34, 36, 38, 39, 40, 42, 45, 47, 48, 51, 53, 58, 59, 61, 63, 64, 67, 68, 71, 73, 74, 75, 79, 82, 83, 86, 87, 88, 89, 92, 93, 94, 95, 96, 97, 99, 100, 101, 103, 104, 105, 107, 109, 110, 112, 113, 114, 115, 116, 117, 120, 121, 122, 125, 126, 127, 128, 129, 130, 131, 133, 134, 137, 138, 139, 140, 141, 143, 144, 146, 147, 148, 149, 150, 151, 153, 157, 158, 159, 160, 162, 164, 165, 166, 167]"
charts,13051,5584,5292,292,"[2, 5, 6, 7, 8, 10, 11, 17, 20, 23, 25, 26, 27, 28, 30, 39, 40, 44, 47, 59, 60, 64, 65, 66, 67, 71, 77, 78, 82, 83, 84, 94, 101, 105, 114, 116, 117, 122, 124, 131, 132, 133, 134, 138, 139, 140, 143, 150, 159, 169, 170, 171, 192, 195, 201, 204, 205, 210, 212, 217, 219, 220, 222, 227, 228, 229, 231, 233, 237, 242, 244, 246, 249, 253, 254, 256, 266, 277, 281, 282, 285, 288, 290, 294, 296, 307, 331, 334, 335, 354, 358, 362, 363, 366, 372, 385, 386, 391, 395, 400]"
pouchdb,13041,3882,3841,41,"[1, 3, 6, 7, 8, 9, 10, 11, 12, 14, 15, 16, 18, 19, 20, 21, 22, 23, 24, 25, 26, 27, 28, 29, 30, 31, 33, 34, 35, 37, 40, 41, 42, 43, 44, 45, 47, 48, 49, 50, 51, 53, 54, 55, 56, 57, 58, 60, 61, 62, 63, 64, 65, 70, 71, 73, 75, 76, 77, 78, 81, 82, 83, 86, 87, 88, 89, 93, 95, 96, 97, 98, 99, 100, 101, 102, 103, 107, 108, 110, 111, 112, 113, 114, 116, 117, 119, 120, 121, 123, 126, 129, 130, 135, 136, 142, 143, 144, 145, 146]"
CircleImageView,13036,328,324,4,"[1, 2, 3, 4, 5, 6, 8, 9, 10, 11, 12, 13, 14, 17, 18, 19, 20, 21, 23, 26, 27, 28, 29, 30, 31, 36, 37, 40, 41, 43, 44, 46, 47, 48, 50, 51, 52, 53, 54, 57, 59, 61, 62, 63, 64, 65, 67, 68, 70, 71, 72, 73, 75, 76, 77, 78, 79, 81, 84, 85, 86, 87, 89, 90, 91, 92, 93, 94, 95, 96, 97, 98, 99, 100, 101, 102, 103, 104, 105, 106, 107, 108, 109, 111, 112, 113, 114, 115, 116, 117, 119, 121, 122, 123, 124, 125, 126, 127, 128, 129]"
p5.js,13035,2625,2535,90,"[1, 2, 3, 4, 5, 6, 7, 8, 9, 10, 11, 12, 13, 14, 15, 17, 18, 19, 20, 21, 22, 23, 24, 25, 26, 27, 28, 29, 30, 31, 32, 33, 34, 35, 36, 37, 38, 39, 40, 41, 42, 43, 44, 45, 46, 47, 48, 49, 52, 53, 54, 55, 58, 59, 60, 61, 62, 65, 66, 67, 68, 69, 70, 72, 73, 75, 76, 77, 78, 79, 80, 81, 82, 83, 85, 86, 89, 90, 91, 92, 93, 96, 97, 98, 99, 100, 102, 103, 105, 106, 107, 108, 110, 112, 113, 115, 116, 117, 118, 121]"
PHP-Parser,13022,410,367,43,"[1, 2, 3, 4, 5, 10, 12, 13, 16, 19, 20, 23, 25, 26, 28, 29, 30, 31, 32, 34, 35, 36, 37, 38, 41, 44, 47, 48, 49, 51, 53, 54, 55, 56, 57, 60, 62, 63, 64, 70, 71, 72, 73, 75, 76, 77, 78, 82, 83, 84, 89, 90, 91, 97, 98, 100, 103, 104, 105, 106, 107, 109, 110, 111, 113, 114, 115, 117, 118, 119, 122, 125, 126, 127, 128, 129, 130, 131, 132, 133, 134, 135, 136, 137, 139, 140, 142, 143, 144, 145, 146, 150, 151, 153, 155, 158, 161, 162, 164, 165]"
Signal-Android,13015,7406,6864,542,"[1, 2, 3, 4, 6, 7, 8, 9, 10, 11, 12, 15, 16, 17, 18, 19, 20, 21, 22, 23, 24, 26, 27, 28, 30, 31, 32, 33, 36, 37, 39, 40, 41, 42, 43, 45, 46, 47, 48, 49, 54, 56, 57, 58, 59, 60, 61, 72, 73, 74, 77, 78, 79, 80, 81, 82, 83, 84, 85, 88, 89, 91, 95, 96, 97, 98, 100, 102, 103, 104, 105, 106, 107, 108, 109, 110, 111, 112, 113, 114, 115, 116, 117, 118, 119, 120, 121, 122, 123, 124, 125, 126, 127, 128, 129, 130, 131, 132, 133, 134]"
vivus,13004,179,172,7,"[1, 2, 3, 4, 5, 7, 9, 10, 12, 16, 17, 18, 19, 20, 21, 22, 23, 24, 25, 26, 27, 30, 38, 39, 40, 41, 42, 43, 44, 45, 46, 47, 49, 50, 51, 53, 54, 56, 58, 59, 60, 61, 62, 63, 64, 65, 66, 69, 71, 72, 74, 75, 76, 77, 78, 79, 80, 81, 82, 83, 84, 85, 86, 90, 91, 92, 93, 95, 96, 97, 98, 99, 101, 102, 104, 105, 106, 107, 108, 109, 110, 112, 113, 114, 115, 116, 117, 119, 120, 121, 122, 123, 124, 126, 127, 128, 130, 131, 132, 134]"
sqlitebrowser,13000,1814,1429,385,"[2, 4, 5, 6, 7, 8, 9, 10, 11, 12, 13, 14, 15, 16, 17, 18, 19, 20, 22, 23, 24, 25, 26, 27, 28, 29, 30, 31, 32, 33, 34, 35, 36, 37, 38, 39, 40, 41, 42, 43, 45, 46, 48, 49, 50, 51, 53, 54, 55, 56, 58, 59, 60, 61, 62, 63, 64, 65, 67, 68, 72, 73, 74, 75, 76, 77, 78, 79, 80, 81, 84, 85, 86, 87, 88, 89, 90, 91, 94, 95, 96, 97, 98, 99, 100, 102, 103, 104, 105, 106, 107, 108, 109, 110, 111, 112, 113, 114, 115, 116]"
git-recipes,12999,0,0,0,[]
envoy,12950,3790,3080,710,"[66, 68, 87, 88, 95, 96, 99, 120, 121, 122, 125, 128, 129, 136, 137, 143, 144, 148, 150, 151, 152, 155, 156, 159, 166, 168, 170, 172, 173, 176, 179, 185, 186, 192, 194, 197, 198, 199, 203, 204, 210, 218, 232, 234, 240, 242, 243, 245, 247, 249, 254, 262, 263, 269, 270, 272, 277, 283, 288, 298, 300, 301, 308, 310, 311, 312, 315, 316, 317, 319, 320, 324, 326, 327, 330, 336, 342, 343, 345, 351, 367, 368, 369, 372, 373, 374, 378, 379, 381, 385, 386, 390, 391, 393, 394, 399, 404, 410, 413, 415]"
awesome-java-cn,12946,14,11,3,"[3, 6, 8, 9, 16, 19, 20, 21, 27, 35, 46, 57, 63, 64]"
flatpickr,12944,1659,1327,332,"[3, 4, 5, 6, 7, 8, 9, 10, 11, 12, 13, 14, 15, 16, 17, 18, 19, 20, 21, 22, 23, 24, 25, 26, 27, 28, 30, 31, 32, 33, 35, 36, 37, 38, 40, 41, 42, 43, 46, 47, 48, 49, 50, 51, 53, 54, 55, 56, 57, 58, 60, 61, 62, 63, 64, 66, 67, 68, 69, 70, 71, 72, 74, 75, 76, 77, 78, 79, 80, 81, 82, 83, 84, 85, 86, 89, 92, 93, 94, 96, 98, 100, 101, 103, 104, 109, 110, 112, 113, 116, 117, 118, 122, 123, 126, 128, 130, 132, 133, 134]"
