owner/login,name,stargazers/totalCount,issues/totalCount,closedIssues/totalCount,openIssues/totalCount,questions/totalCount,answers/totalCount
freeCodeCamp,freeCodeCamp,310708,14411,14215,196,0,0
996icu,996.ICU,249539,0,0,0,0,0
vuejs,vue,163964,8990,8675,315,0,0
facebook,react,148635,9141,8646,495,0,0
EbookFoundation,free-programming-books,147459,427,400,27,0,0
tensorflow,tensorflow,144317,25002,21585,3417,0,0
twbs,bootstrap,140747,19257,18972,285,0,0
sindresorhus,awesome,133036,251,235,16,0,0
getify,You-Dont-Know-JS,121182,834,761,73,0,0
jwasham,coding-interview-university,114936,115,86,29,0,0
ohmyzsh,ohmyzsh,109704,3333,3106,227,0,0
kamranahmedse,developer-roadmap,108087,420,405,15,0,0
github,gitignore,101534,0,0,0,0,0
CyC2018,CS-Notes,100908,399,368,31,0,0
microsoft,vscode,96282,89232,84437,4795,0,0
airbnb,javascript,95373,985,906,79,0,0
donnemartin,system-design-primer,95190,117,33,84,0,0
flutter,flutter,92402,37004,29431,7573,0,0
d3,d3,91478,2036,2032,4,0,0
torvalds,linux,90946,0,0,0,0,1
facebook,react-native,87182,19351,18607,744,0,0
jackfrued,Python-100-Days,85606,353,65,288,0,0
electron,electron,82661,12920,11783,1137,0,0
vinta,awesome-python,82407,167,165,2,0,0
public-apis,public-apis,81870,128,123,5,0,0
facebook,create-react-app,78664,5804,5298,506,0,0
Snailclimb,JavaGuide,78655,383,359,24,0,0
jlevy,the-art-of-command-line,75322,163,80,83,0,0
axios,axios,73194,2288,2054,234,0,0
golang,go,72496,37767,32102,5665,3,17
TheAlgorithms,Python,71643,296,286,10,0,0
danistefanovic,build-your-own-x,70700,315,264,51,0,0
trekhleb,javascript-algorithms,70081,135,83,52,0,0
nodejs,node,69969,11601,10617,984,0,0
animate-css,animate.css,66644,707,706,1,0,0
justjavac,free-programming-books-zh_CN,66427,0,0,0,0,0
ytdl-org,youtube-dl,66110,20283,17488,2795,0,0
kubernetes,kubernetes,66011,34716,32698,2018,0,0
tensorflow,models,63694,5297,4489,808,0,0
FortAwesome,Font-Awesome,62819,15964,10670,5294,0,0
microsoft,terminal,61480,4615,3748,867,0,0
puppeteer,puppeteer,61310,3946,2951,995,0,0
angular,angular,60988,20762,17909,2853,0,0
mrdoob,three.js,60542,9712,9267,445,0,0
microsoft,TypeScript,60363,26315,21853,4462,0,0
ossu,computer-science,59773,450,443,7,0,0
ant-design,ant-design,59705,17292,16830,462,0,0
angular,angular.js,59530,8986,8596,390,0,0
laravel,laravel,59132,0,0,0,0,0
iluwatar,java-design-patterns,57708,542,379,163,0,0
mui-org,material-ui,57327,11082,10693,389,0,0
moby,moby,57046,20177,16576,3601,0,0
30-seconds,30-seconds-of-code,56532,242,242,0,0,0
avelino,awesome-go,54357,218,211,7,0,0
PanJiaChen,vue-element-admin,54289,2707,2111,596,0,0
webpack,webpack,54188,7104,6737,367,0,0
vuejs,awesome-vue,54092,170,109,61,0,0
MisterBooo,LeetCodeAnimation,53982,32,32,0,0,0
denoland,deno,53490,2041,1540,501,0,0
nvbn,thefuck,53462,542,352,190,0,0
jquery,jquery,53314,2008,1945,63,0,0
reduxjs,redux,53196,1760,1729,31,0,0
atom,atom,51892,15682,15110,572,0,0
apple,swift,51574,0,0,0,0,0
hakimel,reveal.js,51554,1781,1312,469,0,0
pallets,flask,50314,1930,1909,21,0,0
socketio,socket.io,49600,2841,2362,479,0,0
shadowsocks,shadowsocks-windows,49300,2495,2447,48,0,0
django,django,49278,0,0,0,0,0
elastic,elasticsearch,48854,23724,21286,2438,0,0
chartjs,Chart.js,48700,5119,4717,402,0,0
expressjs,express,48601,3280,3185,95,0,0
zeit,next.js,48217,6366,5905,461,0,0
keras-team,keras,48198,10108,7138,2970,0,0
storybookjs,storybook,48006,5324,4790,534,0,0
Semantic-Org,Semantic-UI,47854,6092,5212,880,0,0
spring-projects,spring-boot,47684,17134,16710,424,0,0
typicode,json-server,47319,865,394,471,0,0
chrislgarry,Apollo-11,47066,359,264,95,0,0
tonsky,FiraCode,46973,898,656,242,0,0
jakubroztocil,httpie,46698,603,464,139,0,0
netdata,netdata,46647,5247,4528,719,0,0
adam-p,markdown-here,46376,544,291,253,0,0
rails,rails,45579,13738,13350,388,0,0
xingshaocheng,architect-awesome,45330,62,18,44,0,0
ElemeFE,element,45241,15055,13568,1487,0,0
h5bp,html5-boilerplate,44824,1168,1165,3,0,0
lodash,lodash,44764,3670,3607,63,0,0
rust-lang,rust,44734,34192,28756,5436,1,1
josephmisiti,awesome-machine-learning,44617,63,63,0,0,0
opencv,opencv,44503,6587,4863,1724,0,0
awesome-selfhosted,awesome-selfhosted,44418,513,450,63,0,0
h5bp,Front-end-Developer-Interview-Questions,44413,97,93,4,0,0
resume,resume.github.com,44383,83,54,29,0,0
kdn251,interviews,44333,43,16,27,0,0
gatsbyjs,gatsby,44330,10397,9749,648,0,0
moment,moment,44003,3664,3407,257,0,0
gohugoio,hugo,43964,4610,4135,475,0,0
goldbergyoni,nodebestpractices,43766,180,162,18,0,0
doocs,advanced-java,43471,95,85,10,0,0
bitcoin,bitcoin,43373,5422,4930,492,0,0
ansible,ansible,43126,27134,23007,4127,0,0
antirez,redis,42845,4190,2377,1813,0,0
ReactiveX,RxJava,42639,2918,2902,16,0,0
yangshun,tech-interview-handbook,42637,0,0,0,0,0
psf,requests,42460,3133,2913,220,0,0
meteor,meteor,41756,8320,8222,98,0,0
nvm-sh,nvm,41743,1384,1142,242,0,0
mtdvio,every-programmer-should-know,41562,28,16,12,0,0
protocolbuffers,protobuf,41516,3896,2988,908,0,0
kelseyhightower,nocode,41437,3531,418,3113,0,0
apache,incubator-echarts,40971,11910,10169,1741,0,0
ionic-team,ionic,40954,17435,16681,754,0,0
scikit-learn,scikit-learn,40639,7438,5903,1535,0,0
ReactTraining,react-router,40481,5424,5391,33,0,0
gothinkster,realworld,40426,341,141,200,0,0
papers-we-love,papers-we-love,40386,128,117,11,0,0
jekyll,jekyll,40380,4181,4098,83,0,0
google,material-design-icons,40173,863,306,557,0,0
labuladong,fucking-algorithm,40143,165,132,33,0,0
jgthms,bulma,39736,2016,1808,208,0,0
thedaviddias,Front-End-Checklist,39279,108,94,14,0,0
awesomedata,awesome-public-datasets,39173,88,42,46,0,0
necolas,normalize.css,38859,458,439,19,0,0
pytorch,pytorch,38638,14119,9790,4329,0,0
yarnpkg,yarn,38460,5804,3683,2121,0,0
gin-gonic,gin,38025,1379,1166,213,3,15
wasabeef,awesome-android-ui,37854,0,0,0,0,0
scutan90,DeepLearning-500-questions,37815,151,75,76,0,0
NARKOZ,hacker-scripts,37810,56,24,32,0,0
jaywcjlove,awesome-mac,37649,261,209,52,0,0
Dogfalo,materialize,37508,5122,4542,580,0,0
google,guava,37277,3116,2485,631,0,0
aymericdamien,TensorFlow-Examples,37268,208,61,147,0,0
scrapy,scrapy,37094,2189,1749,440,0,0
Hack-with-Github,Awesome-Hacking,37071,0,0,0,0,0
square,okhttp,37027,3071,3009,62,0,0
spring-projects,spring-framework,36966,19476,18605,871,0,0
enaqx,awesome-react,36873,63,60,3,0,0
FreeCodeCampChina,freecodecamp.cn,36827,585,442,143,0,0
nwjs,nw.js,36811,6654,5900,754,0,0
neovim,neovim,36607,5513,4650,863,0,0
babel,babel,36524,7095,6469,626,0,0
prettier,prettier,36475,4199,3579,620,0,0
android,architecture-samples,36375,381,272,109,0,0
minimaxir,big-list-of-naughty-strings,35936,72,27,45,0,0
serverless,serverless,35851,4362,3588,774,0,0
fatedier,frp,35768,1431,1385,46,0,0
sindresorhus,awesome-nodejs,35730,89,89,0,0,0
ryanmcdermott,clean-code-javascript,35703,91,61,30,0,0
impress,impress.js,35680,436,392,44,0,0
parcel-bundler,parcel,35680,2977,2425,552,0,0
square,retrofit,35581,2365,2275,90,0,0
juliangarnier,anime,35367,534,437,97,0,0
nodejs,node-v0.x-archive,35163,6383,5848,535,0,0
ripienaar,free-for-dev,35151,0,0,0,0,0
x64dbg,x64dbg,35067,1796,1409,387,0,0
grafana,grafana,34945,15924,13360,2564,0,0
ziishaned,learn-regex,34896,68,32,36,0,0
vsouza,awesome-ios,34843,432,432,0,0,0
astaxie,build-web-application-with-golang,34639,277,170,107,0,0
ColorlibHQ,AdminLTE,34466,2158,2108,50,0,0
macrozheng,mall,34395,273,260,13,1,8
tesseract-ocr,tesseract,34372,1824,1547,277,0,0
gogs,gogs,34275,4541,3880,661,0,0
ageitgey,face_recognition,34116,985,508,477,0,0
MaximAbramchuck,awesome-interview-questions,34097,22,19,3,0,0
sveltejs,svelte,33673,2778,2380,398,0,0
TryGhost,Ghost,33650,5751,5696,55,0,0
k88hudson,git-flight-rules,33629,54,46,8,0,0
Alamofire,Alamofire,33488,2337,2316,21,0,0
prakhar1989,awesome-courses,33306,58,33,25,0,0
zeit,hyper,33250,2986,2230,756,0,0
bailicangdu,vue2-elm,33133,494,424,70,0,0
home-assistant,core,33121,14352,13383,969,0,2
soimort,you-get,32971,0,0,0,0,0
AFNetworking,AFNetworking,32748,3025,3008,17,0,0
shadowsocks,shadowsocks,32626,0,0,0,0,0
git,git,32528,0,0,0,0,0
tuvtran,project-based-learning,32396,26,15,11,0,0
Unitech,pm2,32358,3950,3096,854,0,0
trimstray,the-book-of-secret-knowledge,32298,37,36,1,0,0
apache,dubbo,32256,3416,2894,522,0,0
azl397985856,leetcode,32057,161,137,24,0,0
leonardomso,33-js-concepts,31799,26,24,2,0,0
JetBrains,kotlin,31744,0,0,0,0,0
gulpjs,gulp,31734,1801,1772,29,0,0
sdmg15,Best-websites-a-programmer-should-visit,31624,46,45,1,0,0
google,material-design-lite,31594,2144,1787,357,0,0
justjavac,awesome-wechat-weapp,31313,0,0,0,0,0
adobe,brackets,31306,9493,6999,2494,0,0
v2ray,v2ray-core,31264,2121,1908,213,0,0
syncthing,syncthing,31162,4062,3819,243,0,0
python,cpython,31054,0,0,0,0,0
etcd-io,etcd,31027,4855,4652,203,0,0
facebook,jest,30936,5361,4435,926,0,0
cdr,code-server,30779,1354,1254,100,0,0
karan,Projects,30742,56,29,27,0,0
prometheus,prometheus,30736,3340,3061,279,0,0
discourse,discourse,30667,0,0,0,0,0
PhilJay,MPAndroidChart,30659,4441,2779,1662,0,0
blueimp,jQuery-File-Upload,30652,3221,3176,45,0,0
mozilla,pdf.js,30624,6756,6164,592,0,0
deepfakes,faceswap,30427,598,585,13,0,0
hexojs,hexo,30387,3463,3332,131,0,0
godotengine,godot,30292,22740,16912,5828,0,0
BVLC,caffe,30255,4704,3866,838,0,0
Genymobile,scrcpy,30206,1268,883,385,0,0
tiimgreen,github-cheat-sheet,30122,43,40,3,0,0
sahat,hackathon-starter,30068,565,555,10,0,0
XX-net,XX-Net,30029,12451,4983,7468,0,0
alvarotrigo,fullPage.js,30009,3493,3336,157,0,0
mermaid-js,mermaid,29933,1009,839,170,0,0
Trinea,android-open-project,29897,80,68,12,0,0
521xueweihan,HelloGitHub,29740,1189,1172,17,0,0
slatedocs,slate,29737,547,506,41,0,0
immutable-js,immutable-js,29678,1165,1022,143,0,0
shadowsocks,shadowsocks-android,29639,2161,2145,16,0,0
pixijs,pixi.js,29479,4042,3972,70,0,0
styled-components,styled-components,29329,2093,1978,115,0,0
junegunn,fzf,29205,1596,1434,162,0,0
algorithm-visualizer,algorithm-visualizer,29190,73,61,12,0,0
koajs,koa,29142,773,750,23,0,0
bumptech,glide,29012,3707,3566,141,0,0
containous,traefik,28786,3722,3231,491,0,0
airbnb,lottie-android,28755,1129,1091,38,0,0
chinese-poetry,chinese-poetry,28741,120,71,49,0,0
apache,incubator-superset,28716,4460,4208,252,0,0
fastlane,fastlane,28705,10510,10359,151,0,0
foundation,foundation-sites,28617,7955,7697,258,0,0
Avik-Jain,100-Days-Of-ML-Code,28608,0,0,0,0,0
exacity,deeplearningbook-chinese,28552,175,130,45,0,0
zenorocha,clipboard.js,28537,523,513,10,0,0
caddyserver,caddy,28495,2140,2070,70,0,0
testerSunshine,12306,28421,624,455,169,0,0
huginn,huginn,28333,1683,1306,377,0,0
videojs,video.js,28290,3999,3771,228,0,0
kamranahmedse,design-patterns-for-humans,28157,49,42,7,0,0
DefinitelyTyped,DefinitelyTyped,27980,6524,3286,3238,0,0
Leaflet,Leaflet,27830,4281,3885,396,0,0
Homebrew,legacy-homebrew,27801,17038,17038,0,0,0
Solido,awesome-flutter,27762,0,0,0,0,0
shadowsocks,ShadowsocksX-NG,27732,1190,982,208,0,0
jashkenas,backbone,27641,2384,2329,55,0,0
lukehoban,es6features,27573,55,36,19,0,0
ariya,phantomjs,27565,4709,4679,30,0,0
photonstorm,phaser,27252,3260,3064,196,0,0
php,php-src,27222,0,0,0,0,0
isocpp,CppCoreGuidelines,27196,799,637,162,0,0
jondot,awesome-react-native,27147,52,33,19,0,0
dypsilon,frontend-dev-bookmarks,27125,93,77,16,0,0
iamkun,dayjs,27114,399,337,62,0,0
nuxt,nuxt.js,27086,5117,4830,287,0,0
joshbuchea,HEAD,27078,82,71,11,0,0
JuliaLang,julia,27064,17734,14836,2898,0,0
Blankj,AndroidUtilCode,27013,1066,1054,12,0,0
tldr-pages,tldr,26945,514,445,69,0,0
nestjs,nest,26841,2578,2507,71,1,10
0voice,interview_internal_reference,26761,36,18,18,0,0
huggingface,transformers,26691,2936,2490,446,0,0
certbot,certbot,26684,4376,3865,511,0,0
codepath,android_guides,26677,362,211,151,0,0
RocketChat,Rocket.Chat,26644,10701,8493,2208,0,0
tastejs,todomvc,26563,734,618,116,0,0
caolan,async,26526,1049,1045,4,0,0
bilibili,ijkplayer,26438,4831,2413,2418,0,0
quilljs,quill,26437,2587,1807,780,0,0
xitu,gold-miner,26235,4380,4339,41,0,0
preactjs,preact,26214,1182,1083,99,0,0
open-guides,og-aws,26164,199,79,120,0,0
floodsung,Deep-Learning-Papers-Reading-Roadmap,26161,41,3,38,0,0
grpc,grpc,26090,8510,8135,375,0,0
apache,spark,26048,0,0,0,0,0
bayandin,awesome-awesomeness,26039,55,49,6,0,0
alex,what-happens-when,26037,100,19,81,0,0
ethereum,go-ethereum,25913,4841,4583,258,0,0
binhnguyennus,awesome-scalability,25909,0,0,0,0,0
Kong,kong,25714,2948,2626,322,0,0
proxyee-down-org,proxyee-down,25618,0,0,0,0,0
kenwheeler,slick,25518,3309,2320,989,0,1
fffaraz,awesome-cpp,25481,450,149,301,0,0
react-boilerplate,react-boilerplate,25433,1787,1762,25,0,0
vuetifyjs,vuetify,25374,8388,7318,1070,0,0
jashkenas,underscore,25325,1357,1324,33,0,0
zxing,zxing,25305,996,988,8,0,0
JakeWharton,butterknife,25273,1122,1029,93,0,0
NervJS,taro,25265,5201,4329,872,0,0
vuejs,vue-cli,25263,4235,3763,472,0,0
shengxinjing,programmer-job-blacklist,25047,290,169,121,0,0
ant-design,ant-design-pro,24978,5397,5309,88,0,0
aosabook,500lines,24958,61,36,25,0,0
pandas-dev,pandas,24903,17940,14586,3354,0,0
getsentry,sentry,24856,4033,3106,927,0,0
apachecn,AiLearning,24853,88,55,33,0,0
strapi,strapi,24733,3468,3235,233,0,0
faif,python-patterns,24705,61,52,9,0,0
square,leakcanary,24696,1131,1094,37,0,0
akullpp,awesome-java,24636,96,95,1,0,0
crossoverJie,JCSprout,24620,87,59,28,0,0
danielmiessler,SecLists,24605,106,98,8,0,0
request,request,24556,2145,2006,139,0,0
Tencent,weui,24540,608,583,25,0,0
nylas,nylas-mail,24528,3421,2416,1005,0,0
wg,wrk,24525,310,222,88,0,0
dylanaraps,pure-bash-bible,24483,47,23,24,0,0
localstack,localstack,24461,1518,1281,237,0,0
select2,select2,24429,4461,4420,41,0,0
Modernizr,Modernizr,24354,1417,1261,156,0,0
google,styleguide,24338,226,77,149,0,0
johnpapa,angular-styleguide,24197,423,361,62,0,0
madewithml,lessons,24146,18,18,0,0,0
yangshun,front-end-interview-handbook,24122,0,0,0,0,0
carbon-app,carbon,24121,428,408,20,0,0
FiloSottile,mkcert,24071,170,133,37,0,0
TheAlgorithms,Java,24006,176,135,41,0,0
houshanren,hangzhou_house_knowledge,23943,0,0,0,0,0
nvie,gitflow,23912,335,114,221,0,0
fzaninotto,Faker,23897,542,486,56,0,0
astaxie,beego,23884,2702,1909,793,0,0
ngosang,trackerslist,23852,214,211,3,0,0
iina,iina,23748,2325,1458,867,0,0
vuejs,vuex,23743,991,959,32,0,0
standard,standard,23718,1075,966,109,1,14
ZuzooVn,machine-learning-for-software-engineers,23715,15,3,12,0,0
Alvin9999,new-pac,23683,877,690,187,0,0
iikira,BaiduPCS-Go,23656,925,793,132,0,0
nolimits4web,swiper,23624,3170,2996,174,0,0
ziadoz,awesome-php,23583,107,106,1,0,0
rethinkdb,rethinkdb,23582,6251,4854,1397,0,0
github,fetch,23563,498,488,10,0,0
Marak,faker.js,23547,428,241,187,0,0
pingcap,tidb,23513,4527,3088,1439,0,0
netty,netty,23508,5067,4691,376,0,0
jakevdp,PythonDataScienceHandbook,23476,114,46,68,0,0
herrbischoff,awesome-macos-command-line,23391,0,0,0,0,0
dkhamsing,open-source-ios-apps,23353,203,202,1,0,0
angular,angular-cli,23337,11707,11070,637,0,0
mathiasbynens,dotfiles,23273,354,228,126,0,0
jiahaog,nativefier,23245,784,610,174,0,0
iview,iview,23243,5425,4432,993,0,0
facebookresearch,Detectron,23233,883,603,280,0,0
symfony,symfony,23229,14009,13252,757,0,0
composer,composer,23028,5946,5590,356,0,0
freeCodeCamp,devdocs,23009,818,719,99,0,0
google-research,bert,22964,925,297,628,0,0
CodeHubApp,CodeHub,22887,606,392,214,0,0
tailwindcss,tailwindcss,22882,831,733,98,0,0
fxsjy,jieba,22872,691,186,505,0,0
raywenderlich,swift-algorithm-club,22858,184,174,10,0,0
istio,istio,22774,9670,8633,1037,0,0
danielgindi,Charts,22746,3626,3128,498,0,0
IanLunn,Hover,22742,96,79,17,0,0
lerna,lerna,22686,1777,1396,381,0,0
SDWebImage,SDWebImage,22661,1896,1874,22,0,0
postcss,postcss,22605,645,627,18,0,0
transloadit,uppy,22587,1110,1017,93,0,0
pi-hole,pi-hole,22581,1804,1682,122,0,0
serhii-londar,open-source-mac-os-apps,22550,127,113,14,0,0
brillout,awesome-react-components,22530,36,36,0,0,0
alacritty,alacritty,22519,2508,2148,360,0,0
greenrobot,EventBus,22474,520,432,88,0,0
GitbookIO,gitbook,22408,0,0,0,0,0
markedjs,marked,22349,986,907,79,0,0
lib-pku,libpku,22343,32,30,2,0,0
date-fns,date-fns,22302,909,755,154,0,0
gitlabhq,gitlabhq,22233,0,0,0,0,0
harvesthq,chosen,22187,2325,2105,220,1,2
skylot,jadx,22157,679,561,118,0,0
ityouknow,spring-boot-examples,22104,96,94,2,0,0
CSSEGISandData,COVID-19,22088,2075,768,1307,0,0
jaredpalmer,formik,22033,1604,1087,517,0,0
3b1b,manim,21962,590,388,202,0,0
hashicorp,terraform,21938,14672,13377,1295,0,0
cheeriojs,cheerio,21908,937,721,216,0,0
sequelize,sequelize,21880,8571,7772,799,0,0
ReactiveX,rxjs,21879,2558,2236,322,0,0
webtorrent,webtorrent,21841,1315,1164,151,0,0
mobxjs,mobx,21822,1506,1490,16,0,0
minio,minio,21806,4058,3968,90,0,0
geekcompany,ResumeSample,21678,0,0,0,0,0
VincentGarreau,particles.js,21631,331,71,260,0,0
alibaba,p3c,21622,590,545,45,0,0
sentsin,layui,21606,485,75,410,0,0
amix,vimrc,21557,404,404,0,0,0
Homebrew,brew,21531,2507,2495,12,0,0
rclone,rclone,21504,3227,2578,649,0,0
ajaxorg,ace,21493,2495,1835,660,1,11
naptha,tesseract.js,21466,358,341,17,0,0
emberjs,ember.js,21451,6250,6000,250,0,0
unknwon,the-way-to-go_ZH_CN,21413,0,0,0,0,0
Polymer,polymer,21404,3887,3638,249,0,0
balderdashy,sails,21333,6127,5770,357,0,0
alibaba,fastjson,21331,2627,1336,1291,0,0
hammerjs,hammer.js,21315,1005,753,252,0,0
ryanoasis,nerd-fonts,21287,345,224,121,0,0
VundleVim,Vundle.vim,21271,685,532,153,0,0
dcloudio,uni-app,21264,1535,1044,491,0,0
elsewhencode,project-guidelines,21241,36,24,12,0,0
tabler,tabler,21187,312,258,54,0,0
kelseyhightower,kubernetes-the-hard-way,21180,294,266,28,0,0
ycm-core,YouCompleteMe,21176,2850,2828,22,0,0
0xAX,linux-insides,21167,154,120,34,0,0
alibaba,druid,21163,2765,1071,1694,0,0
CamDavidsonPilon,Probabilistic-Programming-and-Bayesian-Methods-for-Hackers,21145,210,82,128,0,0
laravel,framework,21106,13617,13614,3,0,1
facebookresearch,fastText,21094,861,568,293,0,0
terryum,awesome-deep-learning-papers,21072,23,11,12,0,0
alibaba,arthas,21054,880,760,120,0,0
StreisandEffect,streisand,21039,1095,922,173,0,0
drone,drone,21026,1708,1678,30,0,0
SheetJS,sheetjs,20988,1698,1360,338,0,0
alibaba,flutter-go,20957,325,173,152,0,0
agalwood,Motrix,20956,541,300,241,0,0
rstacruz,nprogress,20929,133,46,87,0,0
tootsuite,mastodon,20895,5447,3915,1532,0,0
eugenp,tutorials,20850,375,361,14,0,0
microsoft,PowerToys,20846,2084,1182,902,0,0
realpython,python-guide,20830,246,151,95,0,0
cmderdev,cmder,20823,1863,1854,9,0,0
pure-css,pure,20817,534,532,2,0,0
NationalSecurityAgency,ghidra,20796,1494,835,659,0,0
heartcombo,devise,20793,3938,3884,54,0,0
Automattic,mongoose,20773,7423,7105,318,0,0
airbnb,lottie-web,20741,2033,1573,460,0,0
fouber,blog,20725,40,29,11,0,2
t4t5,sweetalert,20720,657,535,122,0,0
ctripcorp,apollo,20697,2008,1839,169,0,0
ocornut,imgui,20684,2550,2142,408,0,0
scwang90,SmartRefreshLayout,20674,1129,1045,84,0,0
satwikkansal,wtfpython,20667,107,81,26,0,0
metabase,metabase,20660,7151,5098,2053,0,0
google,leveldb,20637,574,471,103,0,0
openai,gym,20630,1108,1012,96,0,0
facebook,flow,20604,6290,3875,2415,0,3
remy,nodemon,20552,1290,1279,11,0,0
akveo,ngx-admin,20491,1540,1257,283,0,0
rapid7,metasploit-framework,20475,3845,3160,685,0,0
niklasvh,html2canvas,20441,1887,1308,579,0,0
redux-saga,redux-saga,20359,1314,1161,153,0,0
gorhill,uBlock,20342,3449,3377,72,0,0
littlecodersh,ItChat,20338,800,592,208,0,0
pypa,pipenv,20282,3021,2640,381,0,0
fighting41love,funNLP,20267,26,25,1,0,0
sorrycc,awesome-javascript,20249,71,54,17,0,0
codemirror,CodeMirror,20224,3670,3324,346,0,0
Tencent,wepy,20218,2019,1713,306,0,0
FezVrasta,bootstrap-material-design,20142,1083,1028,55,0,0
ggreer,the_silver_searcher,20114,740,388,352,0,0
vim,vim,20108,3627,2696,931,0,0
kriasoft,react-starter-kit,20098,1147,708,439,0,0
cypress-io,cypress,20084,5424,4220,1204,0,0
SortableJS,Sortable,20076,1399,1169,230,0,0
microsoft,monaco-editor,20009,1789,1427,362,0,0
dimsemenov,PhotoSwipe,20005,1516,1016,500,0,0
JedWatson,react-select,19999,2676,1474,1202,0,0
syl20bnr,spacemacs,19989,7344,5005,2339,0,0
wagoodman,dive,19978,187,134,53,0,0
ovity,octotree,19972,573,513,60,0,0
CymChad,BaseRecyclerViewAdapterHelper,19950,2919,2771,148,0,0
koalaman,shellcheck,19938,1673,1121,552,0,0
aria2,aria2,19933,1343,648,695,0,0
mbeaudru,modern-js-cheatsheet,19885,42,36,6,0,0
facebookarchive,pop,19843,255,211,44,0,0
hashicorp,vagrant,19836,8410,8002,408,0,0
donnemartin,interactive-coding-challenges,19822,52,29,23,0,0
GoogleChrome,lighthouse,19793,6784,6365,419,0,0
google,iosched,19782,199,170,29,0,0
ReactiveCocoa,ReactiveCocoa,19782,1988,1945,43,0,0
angular,components,19779,10883,8756,2127,0,1
bevacqua,dragula,19763,467,289,178,0,0
microsoft,calculator,19757,576,435,141,0,0
Meituan-Dianping,mpvue,19746,1659,1256,403,0,0
kahun,awesome-sysadmin,19740,92,21,71,0,0
Reactive-Extensions,RxJS,19737,874,643,231,0,0
ageron,handson-ml,19735,483,388,95,0,0
go-gitea,gitea,19717,5399,4114,1285,0,0
sharkdp,bat,19691,560,534,26,1,14
BurntSushi,ripgrep,19679,1070,1026,44,0,0
LisaDziuba,Awesome-Design-Tools,19679,24,21,3,0,0
sindresorhus,awesome-electron,19650,44,35,9,0,0
Netflix,Hystrix,19637,997,671,326,0,0
railsware,upterm,19635,753,534,219,0,0
github,hub,19616,1696,1505,191,0,0
SwiftyJSON,SwiftyJSON,19570,646,558,88,0,0
docker,compose,19547,4890,4559,331,0,0
airbnb,lottie-ios,19533,810,677,133,0,0
FFmpeg,FFmpeg,19507,0,0,0,0,0
reduxjs,react-redux,19446,1042,1019,23,0,0
SwiftGGTeam,the-swift-programming-language-in-chinese,19372,321,320,1,0,0
byoungd,English-level-up-tips-for-Chinese,19354,54,43,11,0,0
florinpop17,app-ideas,19353,18,7,11,0,0
alebcay,awesome-shell,19345,37,16,21,0,0
hankcs,HanLP,19341,1370,1363,7,0,0
liyasthomas,postwoman,19320,304,291,13,0,0
MunGell,awesome-for-beginners,19319,57,57,0,0,0
mochajs,mocha,19308,2509,2252,257,0,0
obsproject,obs-studio,19303,472,355,117,0,0
guzzle,guzzle,19282,1586,1356,230,0,0
pyenv,pyenv,19277,1089,906,183,0,0
BradLarson,GPUImage,19256,2199,1300,899,0,0
usablica,intro.js,19252,585,370,215,0,0
atlassian,react-beautiful-dnd,19250,1041,845,196,0,0
powerline,fonts,19234,223,81,142,0,0
markerikson,react-redux-links,19223,32,21,11,0,0
pugjs,pug,19210,2418,2201,217,0,0
kon9chunkit,GitHub-Chinese-Top-Charts,19168,91,28,63,0,0
matteocrippa,awesome-swift,19167,110,110,0,0,0
PowerShell,PowerShell,19142,7455,5048,2407,1,14
dokku,dokku,19119,2008,1973,35,0,0
hashicorp,consul,19118,3737,3155,582,0,0
jgm,pandoc,19108,5012,4444,568,0,0
petkaantonov,bluebird,19097,1113,1057,56,0,0
tornadoweb,tornado,19080,1565,1400,165,0,0
julycoding,The-Art-Of-Programming-By-July,19067,127,82,45,0,0
ColorlibHQ,gentelella,19065,618,605,13,0,0
MrRio,jsPDF,19064,1694,1490,204,0,0
tipsy,profile-summary-for-github,19063,65,54,11,0,0
jobbole,awesome-python-cn,19051,14,12,2,0,0
nefe,You-Dont-Need-jQuery,19045,64,57,7,0,0
emscripten-core,emscripten,19041,5274,4640,634,0,0
typeorm,typeorm,19016,4739,3051,1688,0,0
dmlc,xgboost,19012,3416,3190,226,0,0
FallibleInc,security-guide-for-developers,19003,11,4,7,0,0
bvaughn,react-virtualized,18999,958,684,274,0,0
googlehosts,hosts,18998,378,334,44,0,0
paularmstrong,normalizr,18946,279,264,15,0,0
ReactiveX,RxAndroid,18938,336,336,0,0,0
typicode,husky,18905,498,369,129,0,0
junegunn,vim-plug,18904,746,706,40,0,0
ramda,ramda,18870,1439,1252,187,0,0
futurice,android-best-practices,18866,83,61,22,0,0
influxdata,influxdb,18854,9858,9074,784,0,0
formulahendry,955.WLB,18799,182,59,123,0,0
SamyPesse,How-to-Make-a-Computer-Operating-System,18762,63,25,38,0,0
mitmproxy,mitmproxy,18747,2203,1940,263,0,0
enzymejs,enzyme,18723,1623,1404,219,0,0
jlmakes,scrollreveal,18708,453,444,9,0,0
chubin,cheat.sh,18691,121,60,61,0,0
apache,incubator-mxnet,18680,8913,7217,1696,0,0
domnikl,DesignPatternsPHP,18672,93,90,3,0,0
vapor,vapor,18654,1252,1209,43,0,0
react-native-elements,react-native-elements,18616,1422,1344,78,0,0
doczjs,docz,18579,1061,987,74,0,0
inconshreveable,ngrok,18579,592,372,220,0,0
Advanced-Frontend,Daily-Interview-Question,18570,354,199,155,0,0
google,web-starter-kit,18562,580,533,47,0,0
NativeScript,NativeScript,18523,5637,4998,639,0,0
donnemartin,data-science-ipython-notebooks,18448,27,19,8,0,0
lydiahallie,javascript-questions,18437,108,79,29,0,0
nlohmann,json,18418,1622,1590,32,0,0
Prinzhorn,skrollr,18417,776,533,243,0,0
ReactiveX,RxSwift,18414,1052,1023,29,0,0
postcss,autoprefixer,18409,1020,997,23,0,0
mqyqingfeng,Blog,18408,167,78,89,0,0
HeroTransitions,Hero,18363,542,372,170,0,0
verekia,js-stack-from-scratch,18352,156,118,38,0,0
jinzhu,gorm,18349,2425,1781,644,0,0
chenglou,react-motion,18316,386,241,145,0,0
segmentio,nightmare,18311,1206,1056,150,0,0
wsargent,docker-cheat-sheet,18274,27,22,5,0,0
lukasz-madon,awesome-remote-job,18231,37,35,2,0,0
trailofbits,algo,18222,1262,1199,63,0,0
kubernetes,minikube,18203,4354,3927,427,0,0
mattermost,mattermost-server,18200,4635,4260,375,0,0
nagadomi,waifu2x,18199,265,160,105,0,0
cockroachdb,cockroach,18193,24908,21733,3175,0,0
rollup,rollup,18164,2258,2073,185,0,0
kataras,iris,18125,542,526,16,0,0
ruanyf,es6tutorial,18105,470,470,0,0,0
react-navigation,react-navigation,18099,6896,6744,152,0,0
ftlabs,fastclick,18064,389,179,210,0,0
bcit-ci,CodeIgniter,18047,3108,3055,53,0,0
facebook,draft-js,18032,1501,895,606,0,0
feathericons,feather,18031,457,192,265,0,0
MostlyAdequate,mostly-adequate-guide,18011,227,185,42,0,0
dotnet,corefx,17892,0,0,0,0,0
avajs,ava,17887,1349,1199,150,0,0
mongodb,mongo,17877,0,0,0,0,0
fastai,fastai,17855,1035,1032,3,0,0
tj,commander.js,17842,669,657,12,0,0
veggiemonk,awesome-docker,17807,98,98,0,0,0
google,gson,17798,1263,850,413,0,0
bilibili,flv.js,17759,519,260,259,0,0
SnapKit,Masonry,17722,437,328,109,0,0
balena-io,etcher,17714,1404,1181,223,0,0
cfenollosa,os-tutorial,17701,81,50,31,0,0
tmux,tmux,17687,1868,1864,4,0,0
nsqio,nsq,17672,523,473,50,0,0
afollestad,material-dialogs,17670,1181,1141,40,0,0
Popmotion,popmotion,17666,544,534,10,0,0
swagger-api,swagger-ui,17664,4045,3555,490,0,0
xi-editor,xi-editor,17659,504,382,122,0,0
ipfs,ipfs,17658,202,202,0,0,0
SeleniumHQ,selenium,17657,6455,6057,398,0,0
JohnCoates,Aerial,17638,715,687,28,0,0
react-bootstrap,react-bootstrap,17591,2676,2584,92,0,0
pcottle,learnGitBranching,17584,316,283,33,0,0
QSCTech,zju-icicles,17574,32,26,6,0,0
alibaba,weex,17572,1845,1310,535,0,0
OAI,OpenAPI-Specification,17562,1444,1017,427,0,0
openfaas,faas,17562,681,617,64,0,0
pjreddie,darknet,17546,1922,457,1465,0,0
ianstormtaylor,slate,17525,2218,2033,185,0,0
jcjohnson,neural-style,17522,435,141,294,0,0
acmesh-official,acme.sh,17509,1691,1191,500,0,0
dhg,Skeleton,17492,193,122,71,0,0
ruanyf,jstraining,17464,41,41,0,0,0
square,picasso,17452,1499,1318,181,0,0
parse-community,parse-server,17448,3653,3558,95,0,0
odoo,odoo,17443,12337,11077,1260,0,0
Seldaek,monolog,17399,619,582,37,0,0
dotnet,aspnetcore,17382,15626,13320,2306,0,0
jaredhanson,passport,17372,642,323,319,0,0
jorgebucaran,hyperapp,17349,516,502,14,0,0
encode,django-rest-framework,17324,3427,3271,156,0,0
keon,algorithms,17309,114,77,37,0,0
CorentinJ,Real-Time-Voice-Cloning,17292,298,148,150,0,0
geekcomputers,Python,17234,119,53,66,0,0
vuejs,vue-devtools,17220,882,663,219,0,0
labstack,echo,17216,1000,969,31,0,0
komeiji-satori,Dress,17207,301,224,77,0,0
npm,npm,17197,18672,16505,2167,0,0
davideuler,architecture.of.internet-product,17192,10,3,7,0,0
CMU-Perceptual-Computing-Lab,openpose,17189,1340,1307,33,0,0
denysdovhan,wtfjs,17188,65,29,36,0,0
viatsko,awesome-vscode,17162,32,20,12,0,0
d2l-ai,d2l-zh,17138,0,0,0,0,0
sqlmapproject,sqlmap,17128,3878,3833,45,0,0
curl,curl,17117,2243,2213,30,0,0
helm,helm,17104,4541,4015,526,0,0
localForage,localForage,17085,615,460,155,0,0
felixrieseberg,windows95,17061,140,86,54,0,0
jamiebuilds,the-super-tiny-compiler,17026,0,0,0,0,0
android,architecture-components-samples,16999,555,453,102,0,0
prisma,prisma1,16996,3390,2879,511,0,0
Homebrew,homebrew-cask,16985,5384,5343,41,0,0
airyland,vux,16984,3224,2462,762,0,0
kelthuzadx,hosts,16984,891,888,3,0,0
react-spring,react-spring,16953,711,640,71,0,0
Wox-launcher,Wox,16949,2566,1789,777,0,0
sampotts,plyr,16945,1416,1004,412,0,0
tobiasahlin,SpinKit,16938,55,52,3,0,0
vlang,v,16937,2223,1673,550,7,54
TeamStuQ,skill-map,16937,79,13,66,0,0
stedolan,jq,16929,1658,1163,495,0,0
BoostIO,Boostnote,16920,2250,1821,429,0,0
go-kit,kit,16910,452,398,54,0,0
spf13,cobra,16898,566,399,167,0,0
libgdx,libgdx,16897,3130,2851,279,0,0
bannedbook,fanqiang,16895,480,299,181,0,0
elixir-lang,elixir,16882,4060,4043,17,0,0
kilimchoi,engineering-blogs,16867,76,75,1,0,0
jgraph,drawio,16864,815,556,259,0,0
facebook,docusaurus,16862,898,786,112,0,0
google,python-fire,16846,166,112,54,0,0
nikitavoloboev,my-mac-os,16825,70,68,2,0,0
ruby,ruby,16810,0,0,0,0,0
yeasy,docker_practice,16783,176,172,4,0,0
microsoft,CNTK,16772,3243,2506,737,0,0
osquery,osquery,16765,2450,1830,620,0,0
chrisbanes,PhotoView,16716,615,468,147,0,0
nostra13,Android-Universal-Image-Loader,16714,1205,770,435,0,0
matterport,Mask_RCNN,16701,1967,638,1329,0,0
facebook,flux,16694,228,216,12,0,0
apache,airflow,16693,1132,825,307,0,0
reduxjs,reselect,16658,297,234,63,0,0
hasura,graphql-engine,16652,2506,1675,831,0,0
defunkt,jquery-pjax,16636,441,386,55,0,0
facebook,rocksdb,16616,1929,1584,345,0,0
julianshapiro,velocity,16605,801,763,38,0,0
yunjey,pytorch-tutorial,16588,154,109,45,0,0
angular,material,16587,8927,8504,423,0,0
facebook,hhvm,16538,5719,4895,824,0,0
lovell,sharp,16538,1960,1869,91,0,0
necolas,react-native-web,16534,1183,1096,87,0,0
fengdu78,Coursera-ML-AndrewNg-Notes,16493,45,10,35,0,0
git-tips,tips,16490,27,16,11,0,0
benweet,stackedit,16457,1509,962,547,0,0
SnapKit,SnapKit,16418,485,417,68,0,0
immerjs,immer,16417,369,345,24,0,0
highlightjs,highlight.js,16393,1333,1292,41,0,0
explosion,spaCy,16381,3943,3756,187,0,0
eslint,eslint,16367,7852,7710,142,0,0
InterviewMap,CS-Interview-Knowledge-Map,16360,101,74,27,0,0
vuejs,vuepress,16329,1441,1190,251,0,0
rwaldron,idiomatic.js,16314,75,44,31,0,0
ApolloAuto,apollo,16311,2277,1664,613,0,0
gfwlist,gfwlist,16310,1927,1393,534,0,0
less,less.js,16301,2645,2498,147,0,0
mbadolato,iTerm2-Color-Schemes,16290,57,47,10,0,0
vuejs,vue-router,16287,2392,2277,115,0,0
jesseduffield,lazygit,16271,434,327,107,0,0
Micropoor,Micro8,16236,40,30,10,0,0
adobe-fonts,source-code-pro,16227,186,142,44,0,0
lenve,vhr,16195,189,81,108,0,0
wekan,wekan,16187,2297,1735,562,0,0
goldfire,howler.js,16184,1112,767,345,0,0
sebastianbergmann,phpunit,16177,2687,2586,101,0,0
facebook,fresco,16160,2099,1995,104,0,0
palantir,blueprint,16122,2101,1614,487,0,0
getredash,redash,16116,1892,1515,377,0,0
onevcat,Kingfisher,16086,935,881,54,0,0
jhipster,generator-jhipster,16079,5812,5716,96,0,0
twitter,typeahead.js,16067,1314,903,411,0,0
graphql,graphql-js,16064,821,742,79,0,0
eriklindernoren,ML-From-Scratch,16004,53,33,20,0,0
psf,black,15975,973,708,265,0,0
nicolargo,glances,15940,1205,1050,155,0,0
servo,servo,15936,10967,7813,3154,0,0
wenyan-lang,wenyan,15913,436,285,151,0,0
reactnativecn,react-native-guide,15882,19,18,1,0,0
JacksonTian,fks,15831,26,17,9,0,0
zeit,pkg,15823,805,316,489,0,0
fabricjs,fabric.js,15822,4538,4315,223,0,0
drduh,macOS-Security-and-Privacy-Guide,15811,216,213,3,0,0
laurent22,joplin,15752,2282,2087,195,0,0
uikit,uikit,15735,3672,3111,561,0,0
qiurunze123,miaosha,15733,43,29,14,0,0
ElemeFE,mint-ui,15733,1213,980,233,0,0
mojs,mojs,15728,174,119,55,0,0
apache,kafka,15721,0,0,0,0,0
judasn,IntelliJ-IDEA-Tutorial,15719,67,66,1,0,0
marktext,marktext,15707,1322,995,327,0,0
alsotang,node-lessons,15698,125,43,82,0,0
hashicorp,vault,15698,3610,3112,498,0,0
HelloZeroNet,ZeroNet,15688,1957,1344,613,0,0
jtoy,awesome-tensorflow,15673,10,10,0,0,0
uglide,RedisDesktopManager,15670,4279,4240,39,0,0
Kotlin,anko,15658,616,378,238,0,0
jdg,MBProgressHUD,15629,378,334,44,0,0
zhaoolee,ChromeAppHeroes,15614,36,27,9,0,0
sebastianruder,NLP-progress,15567,79,59,20,0,0
swoole,swoole-src,15559,2385,2344,41,0,0
nosir,cleave.js,15559,417,316,101,0,0
seata,seata,15553,1419,1159,260,0,0
js-cookie,js-cookie,15547,412,408,4,0,0
jashkenas,coffeescript,15540,4056,4020,36,0,0
google,flexbox-layout,15525,270,200,70,0,0
hubotio,hubot,15509,747,683,64,0,0
validatorjs,validator.js,15509,678,582,96,0,0
google,ExoPlayer,15499,6483,6069,414,0,0
iptv-org,iptv,15483,274,219,55,0,0
jenkinsci,jenkins,15462,0,0,0,0,0
eggjs,egg,15430,3245,3116,129,0,0
framework7io,framework7,15430,3039,2942,97,0,0
MLEveryday,100-Days-Of-ML-Code,15418,47,38,9,0,0
mysqljs,mysql,15418,1963,1839,124,0,0
google,googletest,15412,1484,1341,143,0,0
winstonjs,winston,15373,1150,859,291,0,0
reddit-archive,reddit,15372,0,0,0,0,0
YMFE,yapi,15344,1601,741,860,0,0
shuzheng,zheng,15340,89,60,29,0,0
handlebars-lang,handlebars.js,15319,1223,1178,45,0,0
1c7,chinese-independent-developer,15319,52,50,2,0,0
android,plaid,15314,331,271,60,0,0
rubocop-hq,ruby-style-guide,15296,291,228,63,0,0
rust-unofficial,awesome-rust,15285,81,68,13,0,0
StevenBlack,hosts,15276,878,843,35,0,0
FelisCatus,SwitchyOmega,15247,2002,1632,370,0,0
iissnan,hexo-theme-next,15222,1834,1774,60,0,0
phoenixframework,phoenix,15222,1879,1868,11,0,0
Binaryify,NeteaseCloudMusicApi,15172,687,663,24,0,0
bower,bower,15143,1897,1892,5,0,0
ChristosChristofidis,awesome-deep-learning,15120,13,13,0,0,0
libuv,libuv,15093,1192,1121,71,0,0
visionmedia,superagent,15092,958,837,121,0,0
v8,v8,15074,0,0,0,0,0
wangzheng0822,algo,15072,101,17,84,0,0
ruanyf,react-demos,15072,27,27,0,0,0
tensorflow,magenta,15055,684,463,221,0,0
halo-dev,halo,15054,565,502,63,0,0
commaai,openpilot,15049,438,409,29,0,0
jamiebuilds,react-loadable,15043,0,0,0,0,0
ipader,SwiftGuide,15038,27,27,0,0,0
alibaba,ice,15033,1349,1325,24,3,31
fish-shell,fish-shell,15026,5002,4521,481,0,0
golang-standards,project-layout,15023,42,9,33,0,0
statsd,statsd,15018,258,217,41,0,0
facebook,folly,15012,673,494,179,0,0
jesseduffield,lazydocker,15012,131,72,59,0,0
basecamp,trix,15005,601,560,41,0,0
Tencent,tinker,15001,1280,997,283,0,0
poteto,hiring-without-whiteboards,14975,0,0,0,0,0
celery,celery,14952,4112,3719,393,0,0
enyo,dropzone,14947,0,0,0,0,0
datasciencemasters,go,14942,45,22,23,3,17
PHPMailer,PHPMailer,14936,1567,1515,52,0,0
notable,notable,14927,1063,749,314,0,0
jeromeetienne,AR.js,14902,624,619,5,0,0
popperjs,popper-core,14885,618,616,2,0,0
n0shake,Public-APIs,14860,35,31,4,0,0
HubSpot,pace,14850,418,139,279,0,0
keystonejs,keystone-classic,14839,2447,2151,296,0,0
kriskowal,q,14818,547,447,100,2,14
chaozh,awesome-blockchain-cn,14813,25,18,7,0,0
sindresorhus,quick-look-plugins,14813,78,72,6,0,0
sirupsen,logrus,14807,515,439,76,0,0
hapijs,joi,14803,1820,1798,22,1,4
jasmine,jasmine,14789,1255,1193,62,0,0
crystal-lang,crystal,14786,5090,4219,871,0,0
madrobby,zepto,14747,747,678,69,0,0
designmodo,Flat-UI,14719,188,179,9,0,0
dvajs,dva,14717,2035,1999,36,0,0
cjbarber,ToolsOfTheTrade,14717,37,36,1,0,0
electron-react-boilerplate,electron-react-boilerplate,14667,1161,1131,30,0,0
nostalgic-css,NES.css,14659,151,130,21,0,0
dwmkerr,hacker-laws,14653,128,40,88,0,0
bazelbuild,bazel,14651,7654,5738,1916,0,0
angular-ui,bootstrap,14650,4455,4185,270,0,0
desandro,masonry,14631,1075,1044,31,0,0
Developer-Y,cs-video-courses,14627,21,18,3,0,0
quasarframework,quasar,14626,4387,4199,188,0,0
iview,iview-admin,14622,1156,606,550,0,0
joewalnes,websocketd,14612,275,250,25,0,0
portainer,portainer,14608,2570,1988,582,0,0
wagerfield,parallax,14608,244,200,44,0,0
reduxjs,redux-thunk,14605,182,180,2,0,0
alibaba,easyexcel,14601,1200,1186,14,0,0
nuysoft,Mock,14595,371,131,240,0,0
swisskyrepo,PayloadsAllTheThings,14585,43,36,7,0,0
shieldfy,API-Security-Checklist,14586,29,19,10,0,0
oxford-cs-deepnlp-2017,lectures,14568,16,6,10,0,0
hollischuang,toBeTopJavaer,14559,37,27,10,0,0
zziz,pwc,14549,19,4,15,0,0
microsoft,MS-DOS,14541,52,49,3,0,0
tsenart,vegeta,14514,321,287,34,0,0
microsoft,api-guidelines,14512,77,53,24,0,0
wuyouzhuguli,SpringAll,14505,29,22,7,0,0
acdlite,recompose,14504,427,373,54,0,0
tqdm,tqdm,14490,629,416,213,0,0
facebook,relay,14488,1573,1383,190,0,0
ionic-team,ionicons,14478,710,390,320,0,0
nswbmw,N-blog,14461,434,419,15,0,0
chalk,chalk,14459,262,252,10,0,0
yabwe,medium-editor,14459,898,600,298,0,0
AllThingsSmitty,css-protips,14447,43,39,4,0,0
0xd4d,dnSpy,14430,1362,1228,134,0,0
Tencent,mars,14412,699,530,169,0,0
twbs,ratchet,14408,536,334,202,0,0
machinelearningmindset,TensorFlow-Course,14407,10,10,0,0,0
spf13,spf13-vim,14391,720,409,311,0,0
homebridge,homebridge,14386,2243,2224,19,0,0
libra,libra,14381,692,450,242,0,0
PostgREST,postgrest,14377,933,836,97,0,0
briannesbitt,Carbon,14366,902,894,8,0,0
fastify,fastify,14363,892,845,47,0,0
didi,DoraemonKit,14361,334,312,22,0,0
cocos2d,cocos2d-x,14360,4775,3496,1279,0,0
material-components,material-components-web,14352,2472,2177,295,0,0
airbnb,react-sketchapp,14350,287,263,24,0,0
limetext,lime,14341,401,380,21,0,0
binux,pyspider,14334,791,541,250,0,0
altercation,solarized,14328,244,95,149,0,0
google,flatbuffers,14313,1327,1126,201,0,0
dennybritz,reinforcement-learning,14307,141,56,85,0,0
infernojs,inferno,14301,815,782,33,0,0
mxgmn,WaveFunctionCollapse,14294,36,33,3,0,0
leereilly,games,14275,198,75,123,0,0
charlax,professional-programming,14272,7,7,0,0,0
adam-golab,react-developer-roadmap,14264,38,18,20,0,0
hackiftekhar,IQKeyboardManager,14262,1543,1508,35,0,0
android10,Android-CleanArchitecture,14255,246,121,125,0,0
rancher,rancher,14254,22344,19661,2683,0,0
elastic,kibana,14207,24518,18112,6406,0,0
riot,riot,14203,2086,2082,4,0,0
hzlzh,Best-App,14182,65,30,35,0,0
ipython,ipython,14179,6349,5050,1299,0,0
braydie,HowToBeAProgrammer,14172,21,17,4,0,0
Shopify,draggable,14156,225,123,102,0,0
eligrey,FileSaver.js,14117,513,433,80,0,0
svg,svgo,14108,899,626,273,0,0
jsdom,jsdom,14086,1784,1493,291,0,0
google,eng-practices,14086,4,2,2,0,0
facebook,prepack,14081,767,561,206,0,0
xkcoding,spring-boot-demo,14055,89,52,37,0,0
iperov,DeepFaceLab,14047,649,585,64,0,0
trekhleb,homemade-machine-learning,14022,18,7,11,0,0
CarGuo,GSYVideoPlayer,14018,2607,2591,16,0,0
DrKLO,Telegram,13995,0,0,0,0,0
websockets,ws,13977,1154,1147,7,3,29
PKUanonym,REKCARC-TSC-UHT,13973,17,9,8,0,0
recharts,recharts,13973,1795,1703,92,0,0
Eugeny,terminus,13954,1480,1144,336,0,0
luong-komorebi,Awesome-Linux-Software,13931,99,92,7,0,0
mozilla,DeepSpeech,13929,1679,1608,71,0,0
tj,git-extras,13914,305,219,86,0,0
wangshub,wechat_jump_game,13913,984,958,26,0,0
go-delve,delve,13898,1069,972,97,0,0
yudai,gotty,13898,192,118,74,0,0
dotnet-architecture,eShopOnContainers,13891,850,800,50,0,0
xuxueli,xxl-job,13887,1456,1353,103,0,0
realm,realm-cocoa,13861,3957,3503,454,0,0
fbsamples,f8app,13860,203,187,16,0,0
janl,mustache.js,13845,427,373,54,0,0
angular-ui,ui-router,13842,3160,3146,14,0,0
WordPress,WordPress,13824,0,0,0,0,0
apollographql,apollo-client,13810,2739,2207,532,0,0
ccxt,ccxt,13795,4427,4104,323,0,0
SpaceVim,SpaceVim,13789,1729,1673,56,0,0
alibaba,canal,13785,2336,1875,461,0,0
GeekyAnts,NativeBase,13769,2443,2225,218,0,0
huge-success,sanic,13768,873,820,53,0,0
youzan,vant,13717,3918,3896,22,0,0
PerfectlySoft,Perfect,13709,183,134,49,0,0
vim-airline,vim-airline,13696,1474,1451,23,0,0
tiangolo,fastapi,13692,986,797,189,0,0
Carthage,Carthage,13692,1874,1726,148,0,0
menzi11,BullshitGenerator,13691,139,27,112,0,0
numpy,numpy,13690,8450,6582,1868,0,0
urfave,cli,13679,518,446,72,2,19
norvig,pytudes,13659,20,10,10,0,0
MengTo,Spring,13636,220,88,132,0,0
FormidableLabs,webpack-dashboard,13634,206,173,33,0,0
ampproject,amphtml,13630,10815,9005,1810,0,0
css-modules,css-modules,13600,304,218,86,0,0
yaronn,blessed-contrib,13599,113,58,55,0,0
Awesome-HarmonyOS,HarmonyOS,13593,0,0,0,0,0
dotnet,core,13582,3222,2997,225,0,2
apache,incubator-weex,13565,843,690,153,0,0
hemanth,functional-programming-jargon,13562,63,42,21,0,0
docsifyjs,docsify,13560,790,676,114,0,0
hwdsl2,setup-ipsec-vpn,13548,738,733,5,0,0
getlantern,download,13544,0,0,0,0,1
handsontable,handsontable,13537,5912,5111,801,0,0
viraptor,reverse-interview,13529,17,11,6,0,0
pshihn,rough,13522,96,89,7,0,0
react-dnd,react-dnd,13520,1234,1116,118,0,0
30-seconds,30-seconds-of-css,13514,57,57,0,0,0
ibireme,YYKit,13505,483,240,243,0,0
alibaba,spring-cloud-alibaba,13498,921,695,226,0,0
preservim,nerdtree,13480,763,751,12,0,0
TKkk-iOSer,WeChatPlugin-MacOS,13479,554,423,131,0,0
toml-lang,toml,13477,361,331,30,0,0
Awesome-Windows,Awesome,13477,68,63,5,0,0
mybatis,mybatis-3,13463,990,880,110,0,0
Kong,insomnia,13461,1647,1310,337,0,0
fivethirtyeight,data,13449,102,73,29,2,19
amazeui,amazeui,13442,700,564,136,0,0
cool-RR,PySnooper,13440,96,81,15,0,0
geeeeeeeeek,electronic-wechat,13434,594,397,197,0,0
sharkdp,fd,13400,356,332,24,1,10
dbeaver,dbeaver,13400,7950,6652,1298,0,0
cayleygraph,cayley,13381,459,389,70,0,0
realm,SwiftLint,13372,1633,1279,354,0,0
yiisoft,yii2,13366,10622,10157,465,0,0
bokeh,bokeh,13365,5896,5383,513,0,0
you-dont-need,You-Dont-Need-JavaScript,13364,34,9,25,0,0
aFarkas,lazysizes,13359,672,545,127,0,0
source-foundry,Hack,13341,430,333,97,0,0
angular,angular-seed,13339,213,204,9,0,0
cmusatyalab,openface,13330,367,364,3,0,0
oblador,react-native-vector-icons,13329,933,693,240,0,0
apache,skywalking,13325,2297,2207,90,0,0
facebookarchive,AsyncDisplayKit,13322,1365,1343,22,0,0
ccgus,fmdb,13321,526,309,217,0,0
interagent,http-api-design,13318,46,17,29,0,0
so-fancy,diff-so-fancy,13318,214,203,11,0,0
zsh-users,zsh-autosuggestions,13300,379,348,31,0,0
lgvalle,Material-Animations,13298,40,27,13,0,0
kailashahirwar,cheatsheets-ai,13294,14,8,6,0,0
google,fonts,13294,1262,582,680,0,0
haoel,leetcode,13290,50,34,16,0,0
spotify,luigi,13288,838,798,40,0,0
dianping,cat,13287,993,943,50,6,42
frappe,charts,13274,191,98,93,0,0
bitcoinbook,bitcoinbook,13274,264,207,57,0,0
prisma-archive,chromeless,13265,332,160,172,0,0
pubkey,rxdb,13245,368,365,3,0,0
ty4z2008,Qix,13237,21,20,1,0,0
vadimdemedes,ink,13227,158,118,40,2,20
philc,vimium,13221,2607,1925,682,0,0
vurtun,nuklear,13219,659,451,208,0,0
tensorflow,tfjs,13218,2098,1662,436,0,0
browserify,browserify,13195,1415,1098,317,0,0
golang,dep,13187,1351,1087,264,1,16
nfl,react-helmet,13184,322,203,119,0,0
CoderMJLee,MJRefresh,13180,1247,1222,25,0,0
ethereum,wiki,13176,321,303,18,1,2
marcuswestin,WebViewJavascriptBridge,13175,263,197,66,0,0
salomonelli,best-resume-ever,13171,114,92,22,0,0
zyedidia,micro,13165,1169,866,303,1,3
facebook,yoga,13148,460,262,198,0,0
helm,charts,13147,5634,5351,283,0,0
dgraph-io,dgraph,13145,2176,1916,260,0,0
strongloop,loopback,13132,3252,3248,4,0,0
tj,n,13117,405,401,4,7,54
nginx-proxy,nginx-proxy,13107,1050,539,511,0,0
processing,p5.js,13096,2641,2548,93,0,0
substack,stream-handbook,13089,46,11,35,0,0
matomo-org,matomo,13080,10890,9183,1707,0,0
pouchdb,pouchdb,13072,3889,3844,45,0,0
hdodenhof,CircleImageView,13068,328,325,3,0,0
nikic,PHP-Parser,13063,411,367,44,0,0
redisson,redisson,13062,2457,2324,133,0,0
signalapp,Signal-Android,13061,7429,6889,540,0,0
envoyproxy,envoy,13050,3822,3107,715,0,0
sqlitebrowser,sqlitebrowser,13041,1820,1436,384,0,0
geeeeeeeeek,git-recipes,13031,0,0,0,0,0
maxwellito,vivus,13024,179,172,7,0,0
typescript-cheatsheets,react-typescript-cheatsheet,13016,90,60,30,0,0
